id	gerp_cat	n_total	n_genotyped	gerp_count_p	gerp_count_r	gerp_count_t	gerp_Lp	gerp_Lr	gerp_Lt
D154259	0-1	1016065	880915	140182	97532	237714	0.1591322658826334	0.11071669797880612	0.26984896386143953
D154259	1-2	536152	461738	73509	48160	121669	0.1592006722427004	0.10430157361967177	0.26350224586237214
D154259	2-3	421585	364039	56410	36774	93184	0.1549559250519862	0.10101664931504592	0.2559725743670321
D154259	3-4	536380	481434	71027	48342	119369	0.1475321643257435	0.10041251760365907	0.24794468192940258
D154259	4-5	404284	366751	48478	31509	79987	0.13218232533789956	0.08591387617211678	0.21809620151001632
D154280	0-1	1016065	977685	164909	106074	270983	0.16867293657977775	0.10849506742969361	0.27716800400947134
D154280	1-2	536152	522353	87589	53216	140805	0.16768162526107824	0.10187746600478986	0.2695590912658681
D154280	2-3	421585	410974	67692	40210	107902	0.16471114961043765	0.09784073931684242	0.2625518889272801
D154280	3-4	536380	526462	81788	51248	133036	0.15535404264695268	0.09734415779296511	0.2526982004399178
D154280	4-5	404284	398717	55285	33451	88736	0.13865724310726657	0.0838965983391729	0.22255384144643944
D154288	0-1	1016065	999189	169894	107849	277743	0.17003189586754858	0.10793653653112674	0.2779684323986753
D154288	1-2	536152	529248	89880	53265	143145	0.16982586613459097	0.10064279883910757	0.27046866497369854
D154288	2-3	421585	416172	69188	40297	109485	0.16624857030266332	0.09682775390944129	0.2630763242121046
D154288	3-4	536380	530460	83392	51263	134655	0.15720695245635863	0.09663876635373073	0.2538457188100894
D154288	4-5	404284	400576	55549	33443	88992	0.13867281115194122	0.08348727831922033	0.22216008947116153
D154299	0-1	1016065	924281	147770	103226	250996	0.15987562224042257	0.11168248617033132	0.2715581084107539
D154299	1-2	536152	487861	76270	51735	128005	0.15633551359916043	0.10604454957457145	0.26238006317373186
D154299	2-3	421585	384917	59650	39181	98831	0.1549684737229065	0.10179077567371667	0.25675924939662315
D154299	3-4	536380	503742	76172	49835	126007	0.15121232694514256	0.09892961079282649	0.25014193773796906
D154299	4-5	404284	384232	52892	32350	85242	0.13765641591538447	0.08419392450394553	0.22185034041933
D211308	0-1	1016065	978788	161455	108697	270152	0.16495400434006138	0.11105264878604969	0.27600665312611106
D211308	1-2	536152	521536	85231	54203	139434	0.16342304270462635	0.1039295465701313	0.26735258927475763
D211308	2-3	421585	410506	65700	41156	106856	0.1600463817824831	0.10025675629588848	0.2603031380783716
D211308	3-4	536380	525882	81054	51667	132721	0.1541296336440494	0.09824827622926817	0.2523779098733176
D211308	4-5	404284	398087	55152	33321	88473	0.13854257988831586	0.08370280868252417	0.22224538857084003
D211312	0-1	1016065	929793	150483	102917	253400	0.16184570113993116	0.11068807788400213	0.2725337790239333
D211312	1-2	536152	493748	78482	51630	130112	0.15895152993024783	0.1045675121722012	0.26351904210244903
D211312	2-3	421585	388510	60100	39406	99506	0.15469357288100694	0.10142853465805256	0.2561221075390595
D211312	3-4	536380	502348	75818	49646	125464	0.1509272456544069	0.09882790416205499	0.2497551498164619
D211312	4-5	404284	382021	52122	32351	84473	0.13643752568576073	0.08468382628180127	0.221121351967562
D211320	0-1	1016065	979929	159887	109417	269304	0.16316182090743309	0.1116580895146485	0.2748199104220816
D211320	1-2	536152	522408	84454	55267	139721	0.1616629148098804	0.1057927903094899	0.2674557051193703
D211320	2-3	421585	411163	64744	41644	106388	0.15746553070193572	0.10128343260458747	0.2587489633065232
D211320	3-4	536380	526954	81063	52184	133247	0.15383316190787052	0.09902951680791872	0.2528626787157892
D211320	4-5	404284	399065	55141	33480	88621	0.13817548519664716	0.08389610715046421	0.22207159234711138
D211334	0-1	1016065	767624	126274	82601	208875	0.16449980719727367	0.1076060675539066	0.27210587475118025
D211334	1-2	536152	408117	66797	41246	108043	0.16367120213076153	0.10106415562203976	0.26473535775280127
D211334	2-3	421585	323169	52099	31238	83337	0.1612128638576101	0.09666149909180645	0.25787436294941657
D211334	3-4	536380	421744	64652	40805	105457	0.15329678667627755	0.09675300656322319	0.2500497932395007
D211334	4-5	404284	315812	43006	25889	68895	0.13617595278203487	0.08197598571301913	0.21815193849505402
D211341	0-1	1016065	988376	161935	109890	271825	0.16383946999927154	0.11118238403198782	0.27502185403125934
D211341	1-2	536152	525322	84701	55284	139985	0.16123634646940352	0.10523831097879015	0.26647465744819365
D211341	2-3	421585	413280	64621	42119	106740	0.15636130468447543	0.1019139566395664	0.2582752613240418
D211341	3-4	536380	528514	80989	52302	133291	0.15323908165157404	0.09896048165233087	0.2521995633039049
D211341	4-5	404284	399883	54670	33850	88520	0.13671498913432178	0.08464976005481603	0.22136474918913782
D211349	0-1	1016065	983000	166648	107051	273699	0.16953001017293998	0.10890233977619532	0.2784323499491353
D211349	1-2	536152	523910	88390	53233	141623	0.16871218339027697	0.10160714626557997	0.2703193296558569
D211349	2-3	421585	412328	68025	40330	108355	0.1649778816864244	0.09781048097631012	0.26278836266273453
D211349	3-4	536380	527033	81981	51154	133135	0.15555192938582593	0.09706033588029592	0.25261226526612185
D211349	4-5	404284	398930	55106	33267	88373	0.13813450981375178	0.08339056977414584	0.22152507958789763
D211350	0-1	1016065	1000707	164447	110833	275280	0.1643308181115951	0.11075469642962425	0.2750855145412194
D211350	1-2	536152	529006	85301	55315	140616	0.16124769851381648	0.10456403140985168	0.26581172992366814
D211350	2-3	421585	416302	66249	42091	108340	0.1591368765943954	0.10110688874903315	0.2602437653434286
D211350	3-4	536380	530660	81645	52205	133850	0.15385557607507633	0.09837749217955	0.2522330682546263
D211350	4-5	404284	401006	55335	33526	88861	0.13799045400816945	0.08360473409375421	0.22159518810192366
D211374	0-1	1016065	993008	163153	109979	273132	0.1643017981728244	0.11075338768670545	0.2750551858595298
D211374	1-2	536152	526433	84777	54918	139695	0.16104043629483714	0.10432096772048864	0.26536140401532576
D211374	2-3	421585	414030	65414	41838	107252	0.15799338212206845	0.10105064850373162	0.25904403062580006
D211374	3-4	536380	529583	81621	51733	133354	0.15412314972346167	0.0976862928001843	0.25180944252364595
D211374	4-5	404284	400424	55331	33469	88800	0.1381810281102032	0.08358390106487124	0.22176492917507443
D211376	0-1	1016065	998239	162424	111271	273695	0.16271053324905158	0.11146729390456594	0.27417782715361755
D211376	1-2	536152	529039	85524	55047	140571	0.16165915934364009	0.10405093008265931	0.26571008942629937
D211376	2-3	421585	416062	65836	41905	107741	0.15823603212982681	0.10071816219698025	0.25895419432680705
D211376	3-4	536380	529972	79830	52435	132265	0.15063059935241863	0.09893918924018627	0.2495697885926049
D211376	4-5	404284	400280	53975	33971	87946	0.1348431098231238	0.08486809233536524	0.21971120215848905
D211385	0-1	1016065	927683	156270	100266	256536	0.16845193886273652	0.10808217893396775	0.2765341177967043
D211385	1-2	536152	503113	84806	51106	135912	0.16856252969014912	0.10157956562442234	0.27014209531457145
D211385	2-3	421585	396916	65270	39199	104469	0.1644428544074817	0.09875893136079171	0.2632017857682734
D211385	3-4	536380	514738	80431	49829	130260	0.1562561924707327	0.09680458796513955	0.2530607804358722
D211385	4-5	404284	392104	54627	32917	87544	0.13931763001652622	0.08394966641503275	0.223267296431559
D211401	0-1	1016065	949307	153747	105400	259147	0.16195709080413395	0.11102836068837584	0.2729854514925098
D211401	1-2	536152	511097	81200	54126	135326	0.1588739515199659	0.1059016194577546	0.2647755709777205
D211401	2-3	421585	402828	63357	40591	103948	0.15728052667639786	0.10076509080798753	0.25804561748438537
D211401	3-4	536380	519956	79398	51300	130698	0.15270138242466672	0.0986621944933802	0.2513635769180469
D211401	4-5	404284	395296	54173	33386	87559	0.1370441390755282	0.08445822877033919	0.2215023678458674
D211403	0-1	1016065	944189	158596	102520	261116	0.16797060757962654	0.10857995591984232	0.2765505634994689
D211403	1-2	536152	512712	86081	52047	138128	0.1678934762595765	0.10151313017834573	0.26940660643792225
D211403	2-3	421585	403748	66225	39509	105734	0.16402558031247214	0.0978555930927212	0.26188117340519335
D211403	3-4	536380	519010	81907	50166	132073	0.1578139149534691	0.09665709716575789	0.254471012119227
D211403	4-5	404284	393531	55105	32665	87770	0.14002708808200626	0.08300489669174728	0.22303198477375352
D211411	0-1	1016065	1001762	164900	110633	275533	0.16460995725531613	0.1104384075259393	0.27504836478125544
D211411	1-2	536152	530236	86377	54893	141270	0.16290293378797366	0.10352559992154436	0.266428533709518
D211411	2-3	421585	417097	66036	41773	107809	0.15832288412527543	0.1001517632589062	0.25847464738418163
D211411	3-4	536380	531010	81198	52327	133525	0.15291237453155307	0.09854240033144385	0.25145477486299694
D211411	4-5	404284	400879	55418	33545	88963	0.1382412149301909	0.08367861624081081	0.22191983117100172
D211412	0-1	1016065	989904	161729	109380	271109	0.1633784690232588	0.11049556320612908	0.2738740322293879
D211412	1-2	536152	524467	84384	54601	138985	0.1608947750764109	0.10410759876217188	0.26500237383858277
D211412	2-3	421585	413024	65153	41163	106316	0.15774628108778183	0.09966248934686604	0.2574087704346479
D211412	3-4	536380	527432	80990	51712	132702	0.15355533983527733	0.0980448664472387	0.25160020628251606
D211412	4-5	404284	398786	54893	33501	88394	0.13765026856509507	0.08400746264914014	0.2216577312142352
D211431	0-1	1016065	965574	157835	106384	264219	0.16346235503441475	0.11017695174062267	0.27363930677503745
D211431	1-2	536152	509342	81414	53197	134611	0.15984152102123916	0.10444259456318152	0.26428411558442066
D211431	2-3	421585	401221	62970	40184	103154	0.15694592257135095	0.1001542790631597	0.25710020163451064
D211431	3-4	536380	515137	78273	50554	128827	0.15194598718399183	0.0981370004484244	0.2500829876324162
D211431	4-5	404284	389615	53245	32646	85891	0.1366605495168307	0.08379040848016632	0.22045095799699704
D211435	0-1	1016065	1000055	161510	111641	273151	0.16150111743854087	0.11163486008269545	0.2731359775212363
D211435	1-2	536152	530497	84186	56361	140547	0.15869269760243696	0.10624188261196577	0.2649345802144027
D211435	2-3	421585	417039	65060	42470	107530	0.1560045942945384	0.10183699845817777	0.2578415927527162
D211435	3-4	536380	529682	80708	52240	132948	0.15237066768362906	0.0986252128635672	0.25099588054719624
D211435	4-5	404284	399679	54263	33745	88008	0.135766452578194	0.08443025527986209	0.2201967078580561
D211438	0-1	1016065	1001239	165627	109968	275595	0.16542204208985067	0.10983191825328419	0.2752539603431349
D211438	1-2	536152	530159	86980	54600	141580	0.1640639883506646	0.10298797153306838	0.267051959883733
D211438	2-3	421585	416967	66675	41531	108206	0.15990474066293017	0.09960260644127712	0.2595073471042073
D211438	3-4	536380	530925	81855	51939	133794	0.1541743184065546	0.09782737674812826	0.25200169515468285
D211438	4-5	404284	400977	55521	33585	89106	0.13846430094494197	0.08375792127728024	0.2222222222222222
D211445	0-1	1016065	887438	140573	98863	239436	0.15840317858825068	0.11140271207678734	0.269805890665038
D211445	1-2	536152	462727	73377	48261	121638	0.1585751425786695	0.10429691805319335	0.26287206063186286
D211445	2-3	421585	364971	56215	36885	93100	0.15402593630726824	0.10106282416959156	0.2550887604768598
D211445	3-4	536380	482519	70710	48718	119428	0.14654345217494028	0.10096597232440588	0.24750942449934615
D211445	4-5	404284	367695	48386	31634	80020	0.13159276030405634	0.08603326126273134	0.2176260215667877
D211450	0-1	1016065	995463	162357	111102	273459	0.16309697095723297	0.11160836716181315	0.2747053381190461
D211450	1-2	536152	527252	84232	55534	139766	0.15975662491560014	0.10532724389855325	0.2650838688141534
D211450	2-3	421585	414841	65463	41950	107413	0.15780262799482211	0.10112308089123302	0.25892570888605515
D211450	3-4	536380	530001	80501	52194	132695	0.15188839266341006	0.09847905947347269	0.2503674521368828
D211450	4-5	404284	400688	54939	33747	88686	0.13711166793115842	0.0842226370642495	0.2213343049954079
D211451	0-1	1016065	888525	143266	97336	240602	0.16124025773050843	0.10954784614951746	0.2707881038800259
D211451	1-2	536152	477301	75976	49327	125303	0.15917838009976934	0.10334568752212964	0.26252406762189895
D211451	2-3	421585	375630	58532	37929	96461	0.1558235497697202	0.10097436307004233	0.25679791283976255
D211451	3-4	536380	480234	72023	46959	118982	0.14997480394974116	0.09778358050450406	0.24775838445424522
D211451	4-5	404284	363822	49264	30479	79743	0.1354068747904195	0.08377448312636399	0.21918135791678348
D211456	0-1	1016065	766919	122228	83451	205679	0.15937537080187086	0.10881331666055997	0.26818868746243085
D211456	1-2	536152	413043	65348	42411	107759	0.15821113056025643	0.1026793820498108	0.26089051261006724
D211456	2-3	421585	325888	50251	32155	82406	0.15419714748625293	0.09866886783189316	0.2528660153181461
D211456	3-4	536380	426281	63608	41698	105306	0.14921612739014875	0.09781810589728372	0.24703423328743246
D211456	4-5	404284	326535	43595	27312	70907	0.13350789348768127	0.08364187606229041	0.21714976954997167
D211461	0-1	1016065	996059	161589	111020	272609	0.1622283418954098	0.11145926094739368	0.27368760284280347
D211461	1-2	536152	527690	84846	55018	139864	0.16078758361917034	0.10426197199113116	0.2650495556103015
D211461	2-3	421585	415034	65279	41982	107261	0.1572859091062419	0.10115315853640906	0.25843906764265095
D211461	3-4	536380	529925	80758	52238	132996	0.15239515025711187	0.09857621361513422	0.25097136387224606
D211461	4-5	404284	400437	54859	33735	88594	0.1369978298708661	0.08424546183294751	0.22124329170381357
D211474	0-1	1016065	929480	152972	101929	254901	0.16457804363730258	0.1096623918750269	0.27424043551232946
D211474	1-2	536152	500467	81942	51573	133515	0.1637310751757858	0.10304975153206905	0.26678082670785486
D211474	2-3	421585	395012	62612	39574	102186	0.15850657701538182	0.10018429819853573	0.25869087521391754
D211474	3-4	536380	514113	79104	50254	129358	0.15386500633129294	0.09774893846294491	0.2516139447942378
D211474	4-5	404284	392265	54146	32758	86904	0.13803423705913095	0.08350987215275388	0.22154410921188483
D211478	0-1	1016065	1000177	163403	111303	274706	0.16337408278734664	0.11128330285539459	0.2746573856427412
D211478	1-2	536152	529036	84166	56238	140404	0.15909314299972024	0.1063027846876205	0.26539592768734077
D211478	2-3	421585	416339	64762	42549	107311	0.1555511254050185	0.10219796848241457	0.25774909388743306
D211478	3-4	536380	530544	81047	52220	133267	0.1527620706293917	0.09842727464640068	0.2511893452757924
D211478	4-5	404284	400824	54454	33882	88336	0.13585513841486538	0.08453086641518472	0.2203860048300501
D211482	0-1	1016065	999912	164367	110112	274479	0.16438146556897007	0.11012169070878237	0.27450315627775246
D211482	1-2	536152	529592	85894	55121	141015	0.1621890058762217	0.10408201030227043	0.26627101617849214
D211482	2-3	421585	416518	65585	41771	107356	0.1574601817928637	0.10028618210977677	0.25774636390264044
D211482	3-4	536380	530050	81262	51914	133176	0.15331006508819922	0.0979417036128667	0.2512517687010659
D211482	4-5	404284	400139	54689	33639	88328	0.13667500543561112	0.084068286270521	0.2207432917061321
D211489	0-1	1016065	993388	160981	111753	272734	0.1620524910709612	0.11249682903356996	0.27454932010453115
D211489	1-2	536152	528256	84176	56018	140194	0.15934698328083355	0.10604328204506906	0.2653902653259026
D211489	2-3	421585	414849	64503	42493	106996	0.15548548990114475	0.10243004081002967	0.2579155307111744
D211489	3-4	536380	525381	78756	52531	131287	0.1499026420826029	0.09998648599778066	0.24988912808038358
D211489	4-5	404284	396697	53428	33981	87409	0.1346821377524912	0.08565983609656741	0.2203419738490586
D211490	0-1	1016065	965137	159093	106070	265163	0.1648398103067233	0.109901495849812	0.2747413061565353
D211490	1-2	536152	515666	84197	53702	137899	0.16327816842684995	0.10414105254176152	0.2674192209686115
D211490	2-3	421585	406406	64352	40754	105106	0.15834411893525194	0.10027903131351407	0.25862315024876603
D211490	3-4	536380	523371	79891	51664	131555	0.1526469750903279	0.09871391422146049	0.2513608893117884
D211490	4-5	404284	397108	54464	33708	88172	0.13715160611219115	0.08488370921764356	0.2220353153298347
D217810	0-1	1016065	989740	163202	109493	272695	0.16489381049568574	0.110628043728656	0.2755218542243417
D217810	1-2	536152	525523	85252	55217	140469	0.16222315674099896	0.10507056779627152	0.2672937245372705
D217810	2-3	421585	413740	65642	42098	107740	0.1586551940832407	0.10174989123604196	0.26040508531928264
D217810	3-4	536380	528422	81013	52073	133086	0.15331117932258687	0.09854434523922169	0.25185552456180854
D217810	4-5	404284	399673	55281	33382	88663	0.1383155729809119	0.08352328028163024	0.22183885326254213
D217818	0-1	1016065	956687	153032	106754	259786	0.15996036321179236	0.11158717532484501	0.2715475385366374
D217818	1-2	536152	512222	80149	54435	134584	0.15647316983651618	0.10627228037842966	0.2627454502149459
D217818	2-3	421585	403567	62163	41210	103373	0.15403390267291428	0.10211439488362527	0.25614829755653956
D217818	3-4	536380	521215	79575	51392	130967	0.15267212186909432	0.0986003856374049	0.2512725075064992
D217818	4-5	404284	396045	54477	33500	87977	0.1375525508464947	0.08458634751101517	0.22213889835750988
D217821	0-1	1016065	961481	162927	103910	266837	0.16945420658338542	0.10807285843402002	0.27752706501740543
D217821	1-2	536152	511926	85929	51924	137853	0.16785433832233565	0.1014287221199939	0.2692830604423296
D217821	2-3	421585	402696	66264	39285	105549	0.1645509267536802	0.09755497943858395	0.26210590619226415
D217821	3-4	536380	513299	80493	49731	130224	0.15681503373277564	0.09688505140278862	0.25370008513556425
D217821	4-5	404284	387345	54306	31758	86064	0.14020059636757928	0.0819889246020989	0.2221895209696782
D217831	0-1	1016065	889368	141653	98563	240216	0.1592737764345018	0.11082364105747003	0.2700974174919718
D217831	1-2	536152	464962	73100	48989	122089	0.15721714892829952	0.10536129834266027	0.2625784472709598
D217831	2-3	421585	366104	56318	37037	93355	0.15383060551100233	0.10116524266328694	0.2549958481742893
D217831	3-4	536380	485630	73313	47695	121008	0.15096472623190496	0.09821263101538208	0.24917735724728704
D217831	4-5	404284	371295	50865	31165	82030	0.13699349573789035	0.08393595389111085	0.2209294496290012
D217835	0-1	1016065	899551	145268	99586	244854	0.16148945418325364	0.11070634127470261	0.27219579545795625
D217835	1-2	536152	489033	77744	51389	129133	0.15897495670026357	0.10508288806685848	0.2640578447671221
D217835	2-3	421585	385415	59978	38979	98957	0.15561926754277855	0.10113514004384884	0.2567544075866274
D217835	3-4	536380	493220	74857	48609	123466	0.1517720287092981	0.0985543976318884	0.2503264263411865
D217835	4-5	404284	374191	51055	31281	82336	0.13644101541726017	0.08359634518200598	0.22003736059926615
D217864	0-1	1016065	966647	159222	106232	265454	0.1647157649069412	0.10989740825761628	0.27461317316455747
D217864	1-2	536152	517259	83667	54049	137716	0.1617506896931711	0.1044911736673504	0.2662418633605215
D217864	2-3	421585	407687	64600	41224	105824	0.15845489309200442	0.10111678812422276	0.25957168121622715
D217864	3-4	536380	524192	81099	51316	132415	0.15471239545815274	0.09789542762957085	0.25260782308772356
D217864	4-5	404284	397663	55380	33032	88412	0.13926364786263745	0.08306530906823115	0.2223289569308686
D217870	0-1	1016065	989316	162833	109290	272123	0.16459149553833152	0.11047026430382204	0.2750617598421536
D217870	1-2	536152	525716	85823	54482	140305	0.16324973940302367	0.10363390119380045	0.2668836405968241
D217870	2-3	421585	413625	65597	41530	107127	0.1585905107283167	0.10040495618011484	0.25899546690843156
D217870	3-4	536380	528884	81037	52056	133093	0.15322263483107826	0.09842611990531006	0.2516487547363883
D217870	4-5	404284	400102	54716	33800	88516	0.13675512744250215	0.08447845799321173	0.2212335854357139
D217891	0-1	1016065	862352	140300	93981	234281	0.16269458411414364	0.10898217897100024	0.2716767630851439
D217891	1-2	536152	450176	72248	46281	118529	0.16048834233721923	0.10280645791868069	0.2632948002558999
D217891	2-3	421585	355185	56099	35360	91459	0.1579430437659248	0.09955375367766094	0.2574967974435857
D217891	3-4	536380	470153	72175	45548	117723	0.1535138561276861	0.09687910105859157	0.25039295718627763
D217891	4-5	404284	355577	48866	29531	78397	0.13742733641377256	0.08305092849087539	0.22047826490464795
D217896	0-1	1016065	914961	151863	99003	250866	0.16597756625692242	0.10820461199985573	0.27418217825677815
D217896	1-2	536152	478399	79015	48628	127643	0.16516547902483072	0.10164736966423425	0.26681284868906496
D217896	2-3	421585	377083	61067	36772	97839	0.16194577851560532	0.09751699228021417	0.2594627707958195
D217896	3-4	536380	497257	76950	48172	125122	0.1547489527548129	0.09687545876679464	0.2516244115216075
D217896	4-5	404284	379234	52520	31566	84086	0.13848969237990263	0.083236207723991	0.22172590010389365
D217897	0-1	1016065	894116	143195	98743	241938	0.160152597649522	0.11043645343557212	0.2705890510850941
D217897	1-2	536152	464057	73430	48442	121872	0.15823487200925748	0.10438803853836921	0.2626229105476267
D217897	2-3	421585	366241	56852	36658	93510	0.15523111830734407	0.10009256200152358	0.25532368030886765
D217897	3-4	536380	487686	73813	47926	121739	0.1513535348564445	0.0982722489470684	0.2496257838035129
D217897	4-5	404284	373659	51355	31274	82629	0.13743814547488487	0.08369663249112158	0.22113477796600645
D217910	0-1	1016065	927697	149312	102818	252130	0.16094910299375767	0.11083144604326628	0.2717805490370239
D217910	1-2	536152	487147	77083	51004	128087	0.15823355167947253	0.10469940284965318	0.2629329545291257
D217910	2-3	421585	383842	59685	38729	98414	0.15549366666492984	0.10089828627403984	0.25639195293896966
D217910	3-4	536380	501107	74771	49991	124762	0.14921164541704665	0.0997611288607024	0.24897277427774905
D217910	4-5	404284	381597	50651	32945	83596	0.13273427201995822	0.0863345361729783	0.21906880819293653
D217911	0-1	1016065	934584	152131	102618	254749	0.1627793756366469	0.10980072417246604	0.2725800998091129
D217911	1-2	536152	494468	79694	51175	130869	0.16117119813617867	0.10349506944837684	0.2646662675845555
D217911	2-3	421585	389385	61609	38561	100170	0.1582212976873788	0.09903052249059414	0.25725182017797293
D217911	3-4	536380	503653	76292	49633	125925	0.15147730679654445	0.09854602275773201	0.2500233295542765
D217911	4-5	404284	381086	51528	32334	83862	0.13521357383897598	0.08484698991828617	0.22006056375726213
D217932	0-1	1016065	847054	137239	92498	229737	0.16201918649814534	0.10919964960911582	0.27121883610726116
D217932	1-2	536152	467298	74601	48849	123450	0.15964331112052693	0.10453500763966463	0.26417831876019154
D217932	2-3	421585	368544	57400	36985	94385	0.15574802465919946	0.10035436745680298	0.25610239211600244
D217932	3-4	536380	478969	72977	46939	119916	0.15236267900427794	0.0980000793370761	0.250362758341354
D217932	4-5	404284	365609	50322	30615	80937	0.1376388436827321	0.0837369977216097	0.2213758414043418
D217947	0-1	1016065	839157	138512	90945	229457	0.16506088848689815	0.10837662082304027	0.27343750930993843
D217947	1-2	536152	453419	74384	46399	120783	0.16405135206067678	0.10233139766970506	0.26638274973038184
D217947	2-3	421585	357432	57534	35069	92603	0.16096488283086013	0.09811376709416057	0.2590786499250207
D217947	3-4	536380	465245	71718	45408	117126	0.15415103870003977	0.0976001891476534	0.25175122784769316
D217947	4-5	404284	352131	48470	29377	77847	0.13764763681698006	0.08342633849334481	0.22107397531032486
D217949	0-1	1016065	996154	168479	108622	277101	0.1691294719491163	0.10904137312102345	0.2781708450701398
D217949	1-2	536152	527583	88287	53905	142192	0.1673423897282513	0.1021734968715823	0.26951588659983355
D217949	2-3	421585	415057	68613	40408	109021	0.165309824915614	0.097355303006575	0.262665127922189
D217949	3-4	536380	529463	82731	51320	134051	0.15625454469906302	0.09692839726288711	0.2531829419619501
D217949	4-5	404284	400006	55192	33466	88658	0.13797793033104502	0.08366374504382434	0.22164167537486937
D217961	0-1	1016065	923444	150287	102574	252861	0.16274619792862371	0.1110776614499634	0.2738238593785871
D217961	1-2	536152	493743	79392	51495	130887	0.1607962036930144	0.10429514950085368	0.26509135319386806
D217961	2-3	421585	389044	60976	38963	99939	0.1567329145289479	0.10015062563617483	0.2568835401651227
D217961	3-4	536380	500932	75958	49446	125404	0.1516333554254869	0.09870800827257992	0.2503413636980668
D217961	4-5	404284	378633	51782	31906	83688	0.13676039859177622	0.0842662948026189	0.2210266933943951
D217964	0-1	1016065	996922	168315	108111	276426	0.1688346731238753	0.10844479307307894	0.2772794661969542
D217964	1-2	536152	528040	89124	53412	142536	0.16878266797969851	0.10115142792212711	0.2699340959018256
D217964	2-3	421585	415476	68305	40779	109084	0.16440179456815796	0.09815007365046356	0.26255186821862153
D217964	3-4	536380	529367	82840	51135	133975	0.15648878755192522	0.09659650110414891	0.25308528865607416
D217964	4-5	404284	399722	55816	33217	89033	0.139637047748185	0.08310025467700051	0.2227373024251855
D217965	0-1	1016065	947710	159048	102691	261739	0.16782349030821664	0.10835698684196643	0.27618047715018307
D217965	1-2	536152	506406	84337	51492	135829	0.16654028585759253	0.10168125970071444	0.26822154555830696
D217965	2-3	421585	398162	65051	39194	104245	0.1633782229343835	0.09843731948302449	0.261815542417408
D217965	3-4	536380	511628	79701	49483	129184	0.15577919894923656	0.09671675514240816	0.2524959540916447
D217965	4-5	404284	387743	53274	32418	85692	0.1373951302795924	0.083606925205613	0.2210020554852054
D217969	0-1	1016065	841316	135557	91705	227262	0.16112495186113185	0.10900184948342834	0.2701268013445602
D217969	1-2	536152	442570	70398	45703	116101	0.15906636238335178	0.10326727975235556	0.26233364213570737
D217969	2-3	421585	349320	54549	34904	89453	0.15615767777396083	0.09991984426886523	0.2560775220428261
D217969	3-4	536380	469097	71175	45922	117097	0.15172768105530413	0.09789446532380297	0.2496221463791071
D217969	4-5	404284	360478	48968	30200	79168	0.13584185442662242	0.08377765078590094	0.21961950521252338
D217977	0-1	1016065	978782	164960	106243	271203	0.16853599677967107	0.10854613182506422	0.2770821286047353
D217977	1-2	536152	519701	87838	52645	140483	0.16901641520797536	0.10129863132839845	0.2703150465363738
D217977	2-3	421585	408754	67098	39667	106765	0.16415252205483005	0.09704369865493671	0.2611962207097668
D217977	3-4	536380	521626	81743	50387	132130	0.15670806286496455	0.0965960285721954	0.25330409143716
D217977	4-5	404284	394238	55128	32798	87926	0.1398343132828393	0.0831934009405486	0.2230277142233879
D217993	0-1	1016065	932661	155937	101430	257367	0.16719579783007973	0.10875334124617626	0.275949139076256
D217993	1-2	536152	501153	84015	51043	135058	0.16764341428665497	0.10185113129124239	0.26949454557789737
D217993	2-3	421585	395321	64319	38764	103083	0.16270069133691353	0.0980570220150207	0.26075771335193426
D217993	3-4	536380	515321	80383	50232	130615	0.1559862687528744	0.0974771065025489	0.25346337525542334
D217993	4-5	404284	393025	54827	32919	87746	0.13950003180459258	0.08375803065962725	0.22325806246421984
D229025	0-1	1016065	913167	142081	103508	245589	0.15559147450575853	0.11335057004907098	0.2689420445548295
D229025	1-2	536152	492774	75384	53160	128544	0.15297885034518865	0.10787906829499933	0.260857918640188
D229025	2-3	421585	388655	58052	40626	98678	0.14936640465194068	0.10452972430561809	0.25389612895755875
D229025	3-4	536380	503445	72968	51360	124328	0.14493738144186555	0.10201710216607573	0.24695448360794128
D229025	4-5	404284	382736	49919	33433	83352	0.1304267171104887	0.08735263993980184	0.21777935705029053
D229032	0-1	1016065	848564	139985	91719	231704	0.16496693237045174	0.10808730985523779	0.2730542422256895
D229032	1-2	536152	446003	73194	45406	118600	0.164111003737643	0.10180649009087382	0.26591749382851687
D229032	2-3	421585	350610	56160	34532	90692	0.16017797552836485	0.09849120104959927	0.2586691765779641
D229032	3-4	536380	465707	71140	45233	116373	0.15275699098360127	0.09712759310038285	0.24988458408398415
D229032	4-5	404284	358040	48567	30043	78610	0.13564685509998883	0.0839096190369791	0.21955647413696794
D229043	0-1	1016065	810354	128417	89084	217501	0.1584702488048433	0.109932202469538	0.26840245127438134
D229043	1-2	536152	413654	64979	43114	108093	0.1570853902053407	0.10422720437853858	0.2613125945838793
D229043	2-3	421585	326477	50622	32648	83270	0.15505533314751116	0.10000091890087204	0.25505625204838317
D229043	3-4	536380	450329	67357	44365	111722	0.1495728678366261	0.09851686211636382	0.24808972995298992
D229043	4-5	404284	348131	46671	29707	76378	0.13406160324705355	0.08533282011656532	0.21939442336361886
D229051	0-1	1016065	766377	125580	82342	207922	0.1638619113047495	0.10744320354081607	0.2713051148455656
D229051	1-2	536152	396136	64608	40031	104639	0.1630955025546782	0.10105367853464467	0.26414918108932284
D229051	2-3	421585	314244	50569	30567	81136	0.16092272247043699	0.0972715469507771	0.2581942694212141
D229051	3-4	536380	439002	67229	42626	109855	0.15314053238937408	0.0970975075284395	0.25023803991781357
D229051	4-5	404284	339780	46375	28597	74972	0.1364853728883395	0.08416328212372712	0.22064865501206662
D229054	0-1	1016065	900934	146259	99096	245355	0.16234152557235046	0.10999251887485653	0.272334044447207
D229054	1-2	536152	476368	76514	49420	125934	0.16061952104255534	0.10374332448863063	0.264362845531186
D229054	2-3	421585	375705	59281	37635	96916	0.157786028932274	0.10017167724677606	0.25795770617905006
D229054	3-4	536380	492688	74702	48622	123324	0.15162131003799564	0.09868720163673562	0.2503085116747313
D229054	4-5	404284	375902	50961	31963	82924	0.1355699091784561	0.08503014083457923	0.22060005001303531
D229055	0-1	1016065	855541	139668	93005	232673	0.16325108907697	0.10870899232181742	0.2719600813987874
D229055	1-2	536152	454725	73141	47245	120386	0.160846665567101	0.10389796030567926	0.26474462587278025
D229055	2-3	421585	358528	56416	35750	92166	0.1573545162441985	0.09971327204569796	0.25706778828989646
D229055	3-4	536380	477955	72873	46856	119729	0.15246832860834178	0.09803433377619232	0.2505026623845341
D229055	4-5	404284	366243	50503	30598	81101	0.13789478570238886	0.0835456240801872	0.22144040978257604
D229056	0-1	1016065	969147	165781	103483	269264	0.17105867324564797	0.1067774032215959	0.2778360764672439
D229056	1-2	536152	513512	86787	51858	138645	0.1690067612830859	0.10098692922463351	0.2699936905077194
D229056	2-3	421585	404341	66684	39217	105901	0.16492020349160733	0.09698991692655456	0.2619101204181619
D229056	3-4	536380	521583	83290	49606	132896	0.15968695298734814	0.09510662732489364	0.25479358031224175
D229056	4-5	404284	395742	56342	32403	88745	0.14237053433802832	0.08187910305198842	0.22424963739001672
D229063	0-1	1016065	917451	151125	99999	251124	0.16472269363704437	0.10899655676433946	0.27371925040138384
D229063	1-2	536152	485242	79899	49368	129267	0.1646580469126745	0.10173892614406832	0.2663969730567428
D229063	2-3	421585	382481	61570	37486	99056	0.1609753164209464	0.09800748272463207	0.2589827991455785
D229063	3-4	536380	496282	75399	48555	123954	0.15192773463474396	0.09783751979721207	0.24976525443195602
D229063	4-5	404284	375809	50704	31802	82506	0.1349196001160164	0.08462277380264975	0.21954237391866613
D229082	0-1	1016065	901664	146564	99243	245807	0.16254835504134577	0.11006649927245626	0.27261485431380206
D229082	1-2	536152	473088	76788	48728	125516	0.16231229707792208	0.10299986471861472	0.26531216179653677
D229082	2-3	421585	373031	58951	37150	96101	0.15803244234393388	0.09958957834603559	0.2576220206899695
D229082	3-4	536380	487074	73541	47999	121540	0.15098527123188674	0.0985456008737892	0.24953087210567593
D229082	4-5	404284	367742	49359	31063	80422	0.1342218185575757	0.08446954658429007	0.21869136514186577
D229093	0-1	1016065	972967	162005	105994	267999	0.1665061610517109	0.10893894654186627	0.27544510759357715
D229093	1-2	536152	514424	84974	52677	137651	0.16518280640094551	0.10239996578697728	0.2675827721879228
D229093	2-3	421585	405084	65935	40021	105956	0.1627687096997166	0.09879679276396994	0.26156550246368654
D229093	3-4	536380	518263	80009	50445	130454	0.15437914726692817	0.09733475088902739	0.2517138981559556
D229093	4-5	404284	390957	54828	32252	87080	0.1402404868054543	0.08249500584463253	0.22273549265008682
D229096	0-1	1016065	966873	159538	106178	265716	0.16500409050619885	0.10981587033664193	0.27481996084284077
D229096	1-2	536152	510124	84487	52327	136814	0.16562051579615936	0.10257702048913597	0.26819753628529536
D229096	2-3	421585	401739	64754	39651	104405	0.1611842514667483	0.0986984086683145	0.25988266013506284
D229096	3-4	536380	515357	79019	50024	129043	0.15332866343136894	0.09706669357358103	0.25039535700494997
D229096	4-5	404284	390217	53501	32379	85880	0.1371057642286215	0.08297690772057599	0.2200826719491975
D229097	0-1	1016065	942736	153325	103568	256893	0.16263832080243038	0.10985896369715381	0.2724972844995842
D229097	1-2	536152	498944	81151	51044	132195	0.16264550731144176	0.1023040661877886	0.2649495734992304
D229097	2-3	421585	393437	62131	39321	101452	0.15791854858592355	0.09994230334208526	0.2578608519280088
D229097	3-4	536380	506966	77303	49643	126946	0.15248162598675255	0.09792175412157818	0.25040338010833074
D229097	4-5	404284	383752	52126	32174	84300	0.1358325168337885	0.08384060539098168	0.21967312222477017
D229103	0-1	1016065	856917	142347	91837	234184	0.16611527137400706	0.10717140633223521	0.27328667770624226
D229103	1-2	536152	438964	72039	44567	116606	0.16411140776920202	0.10152768791973829	0.26563909568894034
D229103	2-3	421585	346637	55973	33976	89949	0.1614743954049914	0.0980160802222498	0.2594904756272412
D229103	3-4	536380	474789	73300	46235	119535	0.15438436863533064	0.09738009937045719	0.25176446800578783
D229103	4-5	404284	368101	50334	30987	81321	0.13673964482574077	0.08418070040559521	0.22092034523133597
D229126	0-1	1016065	968611	163130	104842	267972	0.16841642310483776	0.10823953062684608	0.27665595373168383
D229126	1-2	536152	513025	85705	52242	137947	0.1670581355684421	0.10183129477120997	0.26888943033965207
D229126	2-3	421585	403937	65724	39478	105202	0.16270854118340236	0.09773306233397783	0.26044160351738016
D229126	3-4	536380	518358	80893	50270	131163	0.15605623912431177	0.09697930773712377	0.25303554686143553
D229126	4-5	404284	393192	54935	32671	87606	0.13971545707949298	0.0830917210930029	0.22280717817249587
D229133	0-1	1016065	939313	153285	103559	256844	0.16318841536314307	0.11024972506502093	0.273438140428164
D229133	1-2	536152	502876	80889	52518	133407	0.16085277483912536	0.10443528822214622	0.26528806306127156
D229133	2-3	421585	395573	62214	39736	101950	0.15727564823686147	0.10045174974025022	0.2577273979771117
D229133	3-4	536380	503663	76840	49243	126083	0.1525623283822715	0.09776973889287083	0.2503320672751423
D229133	4-5	404284	379756	52008	31724	83732	0.1369510949135761	0.0835378506198717	0.2204889455334478
D229154	0-1	1016065	959867	156701	106374	263075	0.1632528256518872	0.11082160340963905	0.27407442906152624
D229154	1-2	536152	509405	82343	52981	135324	0.16164544910238415	0.10400565365475407	0.2656511027571382
D229154	2-3	421585	401151	63110	40290	103400	0.1573223050671692	0.10043599542316983	0.25775830049033904
D229154	3-4	536380	516609	78285	51245	129530	0.1515362682415521	0.09919494240324887	0.25073121064480103
D229154	4-5	404284	391510	53842	32794	86636	0.13752394574851218	0.0837628668488672	0.22128681259737937
D229155	0-1	1016065	972306	162024	106044	268068	0.1666388976309927	0.1090644303336604	0.2757033279646531
D229155	1-2	536152	516176	86375	52368	138743	0.1673363348935247	0.10145376770713865	0.2687901026006633
D229155	2-3	421585	406421	66361	39619	105980	0.16328142492636946	0.09748265960666402	0.26076408453303346
D229155	3-4	536380	520440	80496	50576	131072	0.15466912612404887	0.09717930981477212	0.251848435938821
D229155	4-5	404284	393596	54093	33275	87368	0.13743279911381212	0.0845410014329414	0.22197380054675353
D229160	0-1	1016065	911483	148790	99520	248310	0.16323946798788347	0.1091847022928568	0.2724241702807403
D229160	1-2	536152	475260	76357	49047	125404	0.16066363674620207	0.10320035349072088	0.263863990236923
D229160	2-3	421585	374835	58936	37558	96494	0.1572318486800859	0.1001987541184788	0.2574306027985647
D229160	3-4	536380	495319	75538	48650	124188	0.15250374001401118	0.09821953125157727	0.25072327126558847
D229160	4-5	404284	379136	52352	31704	84056	0.13808237677245105	0.08362170830519919	0.22170408507765024
D229161	0-1	1016065	892504	147289	96843	244132	0.1650289522511944	0.1085070767189839	0.27353602897017826
D229161	1-2	536152	462095	76178	46870	123048	0.1648535474307231	0.10142935976368496	0.26628290719440806
D229161	2-3	421585	364946	59244	35656	94900	0.16233634565113741	0.09770212579395308	0.2600384714450905
D229161	3-4	536380	489948	75833	47631	123464	0.15477764987304776	0.09721643929559871	0.25199408916864646
D229161	4-5	404284	377148	51639	31834	83473	0.1369197238219479	0.08440718232630161	0.22132690614824949
D229162	0-1	1016065	1000264	166673	109776	276449	0.16662900994137547	0.10974702678492877	0.27637603672630423
D229162	1-2	536152	530912	87797	54480	142277	0.16537015550599724	0.10261587607739135	0.2679860315833886
D229162	2-3	421585	417316	67438	41270	108708	0.16159936355184082	0.09889388377153045	0.26049324732337126
D229162	3-4	536380	529711	81401	52116	133517	0.15367058641410128	0.09838572353604134	0.2520563099501426
D229162	4-5	404284	399690	54890	33737	88627	0.13733143185969127	0.08440791613500463	0.22173934799469588
D229164	0-1	1016065	956403	161888	103223	265111	0.16926755771364163	0.1079283523786521	0.2771959100922937
D229164	1-2	536152	512688	86448	52020	138468	0.1686171706769029	0.10146521861248947	0.2700823892893924
D229164	2-3	421585	403465	66383	39359	105742	0.1645322394755431	0.0975524518855415	0.2620846913610846
D229164	3-4	536380	515036	80890	49489	130379	0.15705698242452953	0.09608842877002773	0.25314541119455725
D229164	4-5	404284	389671	54409	32343	86752	0.13962804519710217	0.08300078784410439	0.22262883304120656
D229165	0-1	1016065	866797	143632	93753	237385	0.1657043113900948	0.10816027282051045	0.2738645842106053
D229165	1-2	536152	466955	78092	46859	124951	0.16723667162788705	0.10035014080585923	0.26758681243374627
D229165	2-3	421585	368402	59719	36057	95776	0.16210281160254286	0.09787406148717977	0.2599768730897226
D229165	3-4	536380	484130	74004	47273	121277	0.15285976907029103	0.09764526057050792	0.25050502964079896
D229165	4-5	404284	371390	51034	31074	82108	0.137413500632758	0.08366945798217507	0.2210829586149331
D229167	0-1	1016065	983275	158830	109596	268426	0.16153161628232182	0.11146017136609798	0.2729917876484198
D229167	1-2	536152	519375	83161	54374	137535	0.16011744885679904	0.10469121540312876	0.2648086642599278
D229167	2-3	421585	408989	63921	41438	105359	0.15629026697539541	0.10131812836042045	0.25760839533581587
D229167	3-4	536380	523899	79130	51807	130937	0.1510405631619835	0.09888738096465158	0.2499279441266351
D229167	4-5	404284	396148	53807	33450	87257	0.13582549956077022	0.08443813928127872	0.22026363884204894
D229170	0-1	1016065	984905	160087	109552	269639	0.16254054959615394	0.1112310324346003	0.27377158203075425
D229170	1-2	536152	521929	83088	55061	138149	0.1591940666259204	0.10549519187475691	0.2646892585006773
D229170	2-3	421585	410997	64043	41623	105666	0.15582352182619338	0.1012732453034937	0.2570967671296871
D229170	3-4	536380	524022	79724	51716	131440	0.1521386506673384	0.09869051299372927	0.25082916366106767
D229170	4-5	404284	395630	53780	33585	87365	0.13593509086772995	0.08488992240224452	0.22082501326997447
D229171	0-1	1016065	891368	147948	95434	243382	0.1659785857244146	0.10706464670035272	0.2730432324247673
D229171	1-2	536152	471467	78030	47555	125585	0.16550469067824472	0.10086602031531369	0.2663707109935584
D229171	2-3	421585	371521	60148	36064	96212	0.16189663572180307	0.097071228813445265	0.25896786453524834
D229171	3-4	536380	488424	75764	47071	122835	0.15511932255581215	0.09637323309255892	0.2514925556483711
D229171	4-5	404284	372619	51199	31121	82320	0.1374030846521514	0.08351962728685333	0.22092271193900473
D229186	0-1	1016065	888597	146816	96297	243113	0.16522225485793898	0.10836971090381804	0.27359196576175704
D229186	1-2	536152	475837	78838	48202	127040	0.16568278633229447	0.10129939454056747	0.2669821808728619
D229186	2-3	421585	375208	60421	36736	97157	0.16103334683695444	0.09790836016289631	0.25894170699985075
D229186	3-4	536380	476209	73824	45624	119448	0.15502436955202442	0.09580667312041562	0.25083104267244005
D229186	4-5	404284	360688	49163	29887	79050	0.13630339795058333	0.08286108769906401	0.21916448564964733
D229192	0-1	1016065	899359	144745	99313	244058	0.16094240453478534	0.1104264259322473	0.27136883046703264
D229192	1-2	536152	483073	77218	50443	127661	0.15984747646835987	0.10442107093544868	0.2642685474038085
D229192	2-3	421585	379953	58810	38540	97350	0.15478230202156582	0.10143359836611371	0.25621590038767955
D229192	3-4	536380	486425	74278	47552	121830	0.15270185537338746	0.09775813331962789	0.2504599886930154
D229192	4-5	404284	368986	50406	30904	81310	0.13660680893042013	0.08375385515981636	0.2203606640902365
D229193	0-1	1016065	861385	140384	94269	234653	0.16297474416201815	0.10943886879850473	0.27241361296052286
D229193	1-2	536152	459490	73755	47528	121283	0.16051491871422663	0.10343641863805524	0.2639513373522819
D229193	2-3	421585	362186	57007	36160	93167	0.1573970280463629	0.09983820467936365	0.25723523272572657
D229193	3-4	536380	475902	72770	46376	119146	0.15290963265546267	0.09744863438270905	0.2503582670381717
D229193	4-5	404284	361302	49613	30229	79842	0.1373172581386209	0.08366684933933385	0.22098410747795472
D229509	0-1	1016065	995447	163164	110042	273206	0.16391028352087053	0.11054531280922038	0.2744555963300909
D229509	1-2	536152	527418	85060	55028	140088	0.16127625526622147	0.10433470226651347	0.26561095753273495
D229509	2-3	421585	414803	65138	41830	106968	0.15703357979571025	0.10084305079760754	0.2578766305933178
D229509	3-4	536380	528979	80545	52205	132750	0.1522650237533059	0.09869011813323403	0.25095514188653995
D229509	4-5	404284	399747	54894	33652	88546	0.1373218560739668	0.08418324590303367	0.22150510197700046
D229512	0-1	1016065	998775	168258	108751	277009	0.16846436885184352	0.10888438336962779	0.2773487522214713
D229512	1-2	536152	530522	88407	54365	142772	0.16664153418708366	0.10247454393974237	0.26911607812682603
D229512	2-3	421585	416958	68551	40908	109459	0.16440744631353757	0.09811060106773344	0.262518047381271
D229512	3-4	536380	527746	82364	51261	133625	0.15606750216960433	0.09713195362920798	0.2531994557988123
D229512	4-5	404284	397905	55529	32842	88371	0.13955341099006044	0.08253728905140674	0.2220907000414672
D229518	0-1	1016065	995496	166637	108866	275503	0.16739092874305875	0.10935855091331356	0.2767494796563723
D229518	1-2	536152	527095	87318	54017	141335	0.16565894193646308	0.10248057750500385	0.2681395194414669
D229518	2-3	421585	414706	67580	40624	108204	0.16295881901877474	0.09795855377062304	0.2609173727893978
D229518	3-4	536380	528519	82307	51180	133487	0.15573139281653073	0.09683663217405618	0.2525680249905869
D229518	4-5	404284	399149	55264	32957	88221	0.13845456208082696	0.0825681637684173	0.22102272584924426
D229556	0-1	1016065	961960	147556	110519	258075	0.1533909933884985	0.11488939249033224	0.26828038587883074
D229556	1-2	536152	506321	78692	53957	132649	0.15541919059252923	0.1065667827326933	0.26198597332522255
D229556	2-3	421585	398888	60230	41207	101437	0.1509947654479453	0.10330468702994325	0.25429945247788854
D229556	3-4	536380	517438	71114	54894	126008	0.13743482310924207	0.10608807238741647	0.24352289549665854
D229556	4-5	404284	393935	46500	36882	83382	0.1180397781359869	0.09362458273573052	0.21166436087171742
D229560	0-1	1016065	990868	167583	107259	274842	0.1691274720749888	0.10824751631902534	0.27737498839401414
D229560	1-2	536152	524518	88317	53118	141435	0.16837744367209515	0.10127011847067212	0.26964756214276725
D229560	2-3	421585	412827	68455	40372	108827	0.16582006506357386	0.0977939911875919	0.26361405625116574
D229560	3-4	536380	527365	83038	50479	133517	0.1574583068652641	0.0957192836081272	0.2531775904733913
D229560	4-5	404284	398587	55758	32869	88627	0.13988915845223251	0.08246380338545914	0.22235296183769165
D229599	0-1	1016065	991533	162953	109362	272315	0.16434450492318461	0.11029587517510764	0.2746403800982922
D229599	1-2	536152	524898	84700	54677	139377	0.16136468418626096	0.10416690480817226	0.2655315889944332
D229599	2-3	421585	412992	64928	41265	106193	0.15721369905470323	0.09991718967921896	0.2571308887339222
D229599	3-4	536380	527533	81119	51503	132622	0.15377047502241567	0.09762991130412695	0.2514003863265426
D229599	4-5	404284	398952	55193	33239	88432	0.13834496380516956	0.08331578736289078	0.2216607511680603
D229630	0-1	1016065	993691	167374	108149	275523	0.16843666693167192	0.1088356440784912	0.27727231101016314
D229630	1-2	536152	525949	88301	53758	142059	0.16788890177564744	0.1022114311463659	0.27010033292201335
D229630	2-3	421585	413761	68204	40309	108513	0.16483912210188975	0.09742097491063682	0.26226009701252656
D229630	3-4	536380	527788	82291	51196	133487	0.1559167696120412	0.09700106861088165	0.25291783822292285
D229630	4-5	404284	398537	55112	33418	88530	0.1382857802412323	0.0838516875472039	0.2221374677884362
D229633	0-1	1016065	928606	150543	102329	252872	0.16211719502135458	0.11019635884325538	0.27231355386461
D229633	1-2	536152	491904	78848	51169	130017	0.16029143897996356	0.1040223295602394	0.26431376854020294
D229633	2-3	421585	387872	60957	38702	99659	0.15715751588152793	0.09978033990594835	0.2569378557874763
D229633	3-4	536380	501739	75524	49592	125116	0.150524475872914	0.09884023366730511	0.2493647095402191
D229633	4-5	404284	379543	50938	32141	83079	0.13420877212858623	0.08468342190476441	0.21889219403335064
D229635	0-1	1016065	997753	162517	110843	273360	0.16288299809672332	0.11109262512866411	0.27397562322538743
D229635	1-2	536152	528151	85257	55064	140321	0.1614254256831853	0.10425806256165376	0.26568348824483906
D229635	2-3	421585	415446	64679	42088	106767	0.15568569681739625	0.10130799189304988	0.25699368871044614
D229635	3-4	536380	529051	79552	52825	132377	0.1503673558881847	0.09984859682714899	0.2502159527153337
D229635	4-5	404284	399473	53708	34324	88032	0.13444713409917566	0.08592320382103422	0.22037033792020988
D229638	0-1	1016065	992763	166275	108171	274446	0.16748710417289928	0.1089595401923722	0.27644664436527144
D229638	1-2	536152	525432	87756	53302	141058	0.16701685470241628	0.10144414500829793	0.26846099971071424
D229638	2-3	421585	413493	68017	40745	108762	0.16449371573400276	0.09853854841557173	0.2630322641495745
D229638	3-4	536380	527592	81499	51465	132964	0.15447353257820437	0.0975469681117227	0.25202050068992704
D229638	4-5	404284	398412	55260	33224	88484	0.13870064154694137	0.08339106251819724	0.2220917040651386
D229646	0-1	1016065	998813	164691	110302	274993	0.16488672053727774	0.11043308407079203	0.27531980460806976
D229646	1-2	536152	529190	85991	54826	140817	0.1624955120089193	0.10360362062775184	0.2660991326366711
D229646	2-3	421585	416088	66062	41568	107630	0.15876929880217647	0.09990194381957662	0.2586712426217531
D229646	3-4	536380	529914	81311	52101	133412	0.15344187924833086	0.09831972735198542	0.25176160660031627
D229646	4-5	404284	400078	55159	33223	88382	0.13787061523003014	0.0830413069451457	0.22091192217517583
D229648	0-1	1016065	992462	161515	109895	271410	0.16274174729108015	0.11072968033033002	0.2734714276214102
D229648	1-2	536152	525349	83572	55303	138875	0.1590790122375792	0.10526906875239127	0.2643480809899705
D229648	2-3	421585	413329	64558	41821	106379	0.15619034715686536	0.10118089947717193	0.25737124663403727
D229648	3-4	536380	526209	80839	51548	132387	0.15362527056739814	0.09796107630238175	0.2515863468697799
D229648	4-5	404284	397315	54970	33259	88229	0.13835369920591972	0.08370939934309049	0.22206309854901024
D229658	0-1	1016065	950476	155256	105200	260456	0.16334552371653782	0.11068138490608916	0.27402690862262696
D229658	1-2	536152	502765	81290	52294	133584	0.161685877099639	0.1040128091653158	0.2656986862649548
D229658	2-3	421585	396034	62119	40054	102173	0.1568526944656267	0.10113778109960256	0.25799047556522925
D229658	3-4	536380	510567	77371	50374	127745	0.15153936701745316	0.09866285913504007	0.2502022261524932
D229658	4-5	404284	386821	52059	32982	85041	0.13458162819495323	0.08526424366825999	0.21984587186321322
D229675	0-1	1016065	973771	164178	105058	269236	0.16860021504029182	0.10788778881277016	0.27648800385306194
D229675	1-2	536152	515600	86648	52073	138721	0.16805275407292475	0.10099495733126454	0.2690477114041893
D229675	2-3	421585	405661	66874	39616	106490	0.16485193301796328	0.09765789661811217	0.26250982963607544
D229675	3-4	536380	519815	81422	50094	131516	0.15663649567634638	0.09636890047420717	0.25300539615055356
D229675	4-5	404284	393049	54523	32807	87330	0.1387180733191027	0.0834679645540378	0.2221860378731405
D229676	0-1	1016065	997462	164895	110188	275083	0.16531456837453457	0.11046836871981087	0.2757829370943454
D229676	1-2	536152	528086	86006	55142	141148	0.16286362448540578	0.10441859848585268	0.2672822229712585
D229676	2-3	421585	415614	66855	41442	108297	0.16085839264317373	0.0997127142011578	0.26057110684433155
D229676	3-4	536380	529476	81991	51596	133587	0.1548531000460833	0.0974472875068936	0.2523003875529769
D229676	4-5	404284	399749	55267	33550	88817	0.1382542545447268	0.08392766460954248	0.2221819191542693
D229679	0-1	1016065	887262	142434	97924	240358	0.16053206380978785	0.11036649828348334	0.27089856209327123
D229679	1-2	536152	470237	74337	49304	123641	0.15808411503135653	0.10484925686409194	0.26293337189544846
D229679	2-3	421585	370736	57311	37495	94806	0.15458709162314963	0.10113665789132968	0.2557237495144793
D229679	3-4	536380	479997	72311	47116	119427	0.15064885822203056	0.098158946826751	0.24880780504878156
D229679	4-5	404284	361744	48703	30506	79209	0.13463388473616703	0.08433035516829582	0.21896423990446282
D229705	0-1	1016065	948942	154413	104867	259280	0.16272122005349116	0.11050938835039444	0.2732306084038856
D229705	1-2	536152	503357	80948	52269	133217	0.16081627949944075	0.1038408127829751	0.26465709228241585
D229705	2-3	421585	396105	62613	39600	102213	0.15807172340667247	0.09997349187715379	0.25804521528382623
D229705	3-4	536380	510832	77158	50650	127808	0.1510437873899834	0.09915197168540733	0.2501957590753907
D229705	4-5	404284	387056	51961	33031	84992	0.1342467239882601	0.08533907238229094	0.21958579637055103
D229707	0-1	1016065	975680	159991	107624	267615	0.16397896851426697	0.11030665792062971	0.2742856264348967
D229707	1-2	536152	515057	82610	53777	136387	0.16039001508570896	0.10440980318683175	0.26479981827254073
D229707	2-3	421585	405451	63900	40502	104402	0.15760227499747195	0.0998936986220283	0.2574959736195003
D229707	3-4	536380	522803	80051	51479	131530	0.15311886121541002	0.09846730030240837	0.2515861615178184
D229707	4-5	404284	396487	54391	33218	87609	0.1371823035812019	0.0837808049192029	0.2209631085004048
D229714	0-1	1016065	934368	152677	102953	255630	0.16340135792321656	0.11018463817254015	0.2735859960957567
D229714	1-2	536152	502151	81031	52222	133253	0.16136779574271484	0.10399660659841363	0.26536440234112846
D229714	2-3	421585	395447	61995	39598	101593	0.15677195679825615	0.10013478418093955	0.2569067409791957
D229714	3-4	536380	506059	76991	49605	126596	0.1521383870260187	0.09802216737574078	0.2501605544017595
D229714	4-5	404284	382431	52255	32189	84444	0.13663902769388464	0.08416943187137026	0.2208084595652549
D229716	0-1	1016065	991919	159906	110754	270660	0.16120872772877623	0.11165629451598366	0.2728650222447599
D229716	1-2	536152	524825	82564	56005	138569	0.1573172009717525	0.10671176106321155	0.264028962034964
D229716	2-3	421585	412954	63936	42191	106127	0.15482596124507814	0.10216876455973305	0.2569947258048112
D229716	3-4	536380	526454	78356	52731	131087	0.1488373153209967	0.10016259730194851	0.2489999126229452
D229716	4-5	404284	397329	53153	33978	87131	0.13377578782318936	0.08551603331244384	0.2192918211356332
D229718	0-1	1016065	995383	160553	111602	272155	0.16129771153415318	0.11211965645384742	0.2734173679880006
D229718	1-2	536152	526880	84342	55242	139584	0.16007819617370178	0.10484740358335864	0.2649255997570604
D229718	2-3	421585	414562	64292	42032	106324	0.15508416111462217	0.10138893579247495	0.25647309690709713
D229718	3-4	536380	528321	77562	53491	131053	0.14680847439340855	0.10124715845101746	0.24805563284442603
D229718	4-5	404284	398717	51824	34813	86637	0.12997690090966776	0.08731255502022738	0.21728945592989513
D229721	0-1	1016065	991380	167585	107730	275315	0.16904214327503075	0.10866670701446468	0.27770885028949543
D229721	1-2	536152	524635	87875	53204	141079	0.16749740295634108	0.10141145748949269	0.2689088604458338
D229721	2-3	421585	412768	67632	40320	107952	0.163849910845802	0.09768199085200403	0.26153190169780605
D229721	3-4	536380	527065	82499	51009	133508	0.156525286255016	0.09677933461717246	0.2533046208721884
D229721	4-5	404284	398617	55472	33240	88712	0.13916114967500132	0.08338831509945636	0.2225494647744577
D229734	0-1	1016065	980095	163827	106662	270489	0.16715420443936557	0.10882822583525066	0.2759824302746162
D229734	1-2	536152	518490	87194	52609	139803	0.16816910644371155	0.10146579490443403	0.26963490134814555
D229734	2-3	421585	408092	66951	39747	106698	0.1640585946306225	0.09739715554335787	0.2614557501739804
D229734	3-4	536380	522483	80789	50651	131440	0.15462512655914162	0.09694286704065012	0.25156799359979176
D229734	4-5	404284	394960	55041	32653	87694	0.13935841604213084	0.0826741948551752	0.22203261089730605
D229735	0-1	1016065	898012	143989	99356	243345	0.160341955341354	0.11063994690494114	0.27098190224629515
D229735	1-2	536152	476895	75444	49771	125215	0.15819834554776208	0.10436469243753867	0.26256303798530073
D229735	2-3	421585	376463	58321	38094	96415	0.1549182788215575	0.10118922709535864	0.2561075059169161
D229735	3-4	536380	492333	74374	48517	122891	0.15106442184456456	0.09854509041644578	0.24960951226101033
D229735	4-5	404284	374617	51507	31433	82940	0.13749242559734343	0.0839070303803618	0.22139945597770522
D229737	0-1	1016065	1000317	158459	113596	272055	0.15840878441534034	0.11356000147953099	0.27196878589487133
D229737	1-2	536152	530688	82265	57271	139536	0.15501575313555235	0.10791840026531596	0.2629341534008683
D229737	2-3	421585	417219	64148	43044	107192	0.15375138716117914	0.10316883938650924	0.25692022654768837
D229737	3-4	536380	530213	80254	52627	132881	0.1513618111966323	0.0992563366043458	0.2506181478009781
D229737	4-5	404284	399805	54749	33831	88580	0.1369392578882205	0.0846187516414252	0.2215580095296457
D229740	0-1	1016065	948602	155116	104257	259373	0.16352063352175095	0.10990594580234914	0.2734265793241001
D229740	1-2	536152	499664	80862	51664	132526	0.1618327516090813	0.10339748310864902	0.26523023471773033
D229740	2-3	421585	393475	61891	39643	101534	0.15729334773492598	0.10075100069890082	0.2580443484338268
D229740	3-4	536380	512848	78276	50321	128597	0.15263001903097995	0.09812069073097682	0.25075070976195674
D229740	4-5	404284	390864	53651	32844	86495	0.13726257726472635	0.08402922755741127	0.22129180482213762
D229742	0-1	1016065	968920	162928	104785	267713	0.1681542335796557	0.10814618337943277	0.27630041695908847
D229742	1-2	536152	515551	86066	52566	138632	0.16693983718390615	0.10196081473995783	0.268900651923864
D229742	2-3	421585	405661	66533	39804	106337	0.1640113296570289	0.098121337767249	0.26213266742427793
D229742	3-4	536380	518180	80775	50203	130978	0.15588212590219616	0.09688332239762244	0.2527654482998186
D229742	4-5	404284	391571	54055	32794	86849	0.13804648454558688	0.08374981804066185	0.22179630258624872
D229753	0-1	1016065	973746	158141	107862	266003	0.16240477496184838	0.11077015977472565	0.273174934736574
D229753	1-2	536152	513782	82375	53740	136115	0.1603306460716802	0.10459689128852315	0.26492753736020336
D229753	2-3	421585	404521	63724	40521	104245	0.1575295225711397	0.10017032490278625	0.25769984747392594
D229753	3-4	536380	520437	78587	51620	130207	0.15100194644116388	0.0991858764845697	0.25018782292573355
D229753	4-5	404284	394595	53250	33683	86933	0.13494849149127586	0.0853609396976647	0.22030943118894056
D229759	0-1	1016065	972656	162798	105794	268592	0.16737469362241122	0.10876815647053018	0.27614285009294137
D229759	1-2	536152	514237	85192	52337	137529	0.1656668034388813	0.10177602934055698	0.26744283277943826
D229759	2-3	421585	404938	65837	39872	105709	0.1625853834414157	0.09846445628713532	0.26104983972855106
D229759	3-4	536380	520661	81176	50674	131850	0.15590950733778794	0.09732628332062512	0.25323579065841306
D229759	4-5	404284	394518	54784	32903	87687	0.13886311904653273	0.08340050390603217	0.2222636229525649
D229770	0-1	1016065	927164	150561	102330	252891	0.1623887467589337	0.11036882363853644	0.2727575703974701
D229770	1-2	536152	487895	77836	50770	128606	0.15953432603326537	0.10405927504893471	0.2635936010822001
D229770	2-3	421585	384382	59868	38532	98400	0.1557513098948442	0.10024402807623665	0.25599533797108087
D229770	3-4	536380	498379	75037	49327	124364	0.15056212240082348	0.09897487654977437	0.24953699895059783
D229770	4-5	404284	376309	50999	31674	82673	0.1355242633048904	0.08417018992370631	0.2196944532285967
D229771	0-1	1016065	981529	160566	108483	269049	0.16358762705941443	0.11052449800260614	0.2741121250620206
D229771	1-2	536152	519695	84279	53956	138235	0.16217011901211287	0.10382243431243325	0.26599255332454613
D229771	2-3	421585	408946	64679	41119	105798	0.15816024609606158	0.10054872770488035	0.25870897380094193
D229771	3-4	536380	520597	79183	51203	130386	0.15210037706709797	0.09835438928768318	0.25045476635478114
D229771	4-5	404284	392378	53585	32943	86528	0.13656474114246975	0.08395730647487881	0.2205220476173486
D229772	0-1	1016065	827850	126488	93334	219822	0.1527909645467174	0.11274264661472488	0.2655336111614423
D229772	1-2	536152	427258	64680	45685	110365	0.15138394131882843	0.10692602596089482	0.2583099672797233
D229772	2-3	421585	337568	50095	34944	85039	0.14839972983221159	0.10351692103516921	0.2519166508673808
D229772	3-4	536380	466863	67177	47543	114720	0.14389017763241035	0.10183501369780856	0.24572519133021892
D229772	4-5	404284	363565	47312	31511	78823	0.13013353870697125	0.08667225943091332	0.21680579813788456
D229775	0-1	1016065	906156	147341	99273	246614	0.1626000379625583	0.10955398408221101	0.27215402204476935
D229775	1-2	536152	485870	77955	50459	128414	0.16044415172782844	0.10385288245827073	0.2642970341860992
D229775	2-3	421585	382665	59652	38323	97975	0.15588569636627336	0.10014764872669306	0.25603334509296644
D229775	3-4	536380	490656	74148	48196	122344	0.15112013304637056	0.09822767886258398	0.24934781190895455
D229775	4-5	404284	370882	50531	31068	81599	0.1362454904794517	0.08376788304635976	0.22001337352581143
D229776	0-1	1016065	985810	160481	109202	269683	0.16279100435175134	0.11077388137673588	0.27356488572848725
D229776	1-2	536152	521314	83455	54646	138101	0.16008585996155866	0.10482358041410743	0.2649094403756661
D229776	2-3	421585	410394	64309	41376	105685	0.15670063402486392	0.10082018742964079	0.2575208214545047
D229776	3-4	536380	522023	78938	51803	130741	0.15121555946768628	0.09923509117414367	0.25045065064183
D229776	4-5	404284	393603	53062	33419	86481	0.1348109643473246	0.08490534879053259	0.2197163131378572
D229777	0-1	1016065	999468	168555	108786	277341	0.16864471899050296	0.10884390495743736	0.2774886239479403
D229777	1-2	536152	529522	88821	53936	142757	0.16773807320564585	0.10185790203239903	0.2695959752380449
D229777	2-3	421585	416451	68339	40770	109109	0.16409853740295977	0.09789867235280982	0.26199720975576957
D229777	3-4	536380	530228	82419	51734	134153	0.15544067834969108	0.09756934752596996	0.253010025875661
D229777	4-5	404284	400330	55979	33024	89003	0.13983213848574927	0.08249194414607948	0.22232408263182873
D229780	0-1	1016065	974561	159559	107080	266639	0.16372397417914322	0.10987511299959674	0.27359908717874
D229780	1-2	536152	514451	82745	53401	136146	0.16084136292863654	0.10380191699501022	0.2646432799236468
D229780	2-3	421585	405149	63621	40704	104325	0.15703111694709848	0.10046674186533842	0.2574978588124369
D229780	3-4	536380	521238	79885	51112	130997	0.1532601230148224	0.0980588521941992	0.2513189752090216
D229780	4-5	404284	395163	54542	33044	87586	0.13802405589592143	0.08362118923077312	0.22164524512669456
D229783	0-1	1016065	971444	156279	108357	264636	0.1608728861365143	0.11154219903566237	0.27241508517217666
D229783	1-2	536152	513854	80940	54369	135309	0.1575155588941606	0.10580631852627401	0.2633218774204346
D229783	2-3	421585	404321	62251	41182	103433	0.15396430064231142	0.10185471444718429	0.2558190150894957
D229783	3-4	536380	517836	78567	51052	129619	0.15172178064097513	0.09858719749109757	0.2503089781320727
D229783	4-5	404284	391210	53659	32800	86459	0.1371616267477825	0.0838424375655019	0.22100406431328443
D229784	0-1	1016065	922673	151165	101372	252537	0.16383377426238765	0.10986774295985685	0.2737015172222445
D229784	1-2	536152	492263	79982	51327	131309	0.16247818747295653	0.10426743427801805	0.2667456217509746
D229784	2-3	421585	387535	60828	39147	99975	0.15696130672068329	0.10101539215812766	0.257976698878811
D229784	3-4	536380	500960	76239	49497	125736	0.15218580325774514	0.09880429575215587	0.250990099009901
D229784	4-5	404284	380710	52723	31753	84476	0.13848598670904363	0.08340469123479814	0.22189067794384176
D237206	0-1	1016065	1001435	159232	113056	272288	0.1590038295046608	0.1128939971141412	0.271897826618802
D237206	1-2	536152	529631	85395	55143	140538	0.16123489750411135	0.10411588445540386	0.2653507819595152
D237206	2-3	421585	416617	65471	41926	107397	0.15714913217655543	0.10063439561995789	0.25778352779651337
D237206	3-4	536380	530581	77731	53959	131690	0.14650166515574436	0.1016979499831317	0.24819961513887606
D237206	4-5	404284	400665	51890	35227	87117	0.12950969014014202	0.08792133078756567	0.2174310209277077
D237232	0-1	1016065	980790	162194	107572	269766	0.16537077254050306	0.10967893228927701	0.2750497048297801
D237232	1-2	536152	517265	84877	53180	138057	0.1640880399795076	0.10280997167796004	0.2668980116574676
D237232	2-3	421585	407490	65275	40606	105881	0.16018798007313062	0.09964907114285013	0.2598370512159808
D237232	3-4	536380	524111	80914	51300	132214	0.15438332719595657	0.09788002923044928	0.25226335642640585
D237232	4-5	404284	397031	54564	33460	88024	0.13743007472968105	0.08427553515972304	0.2217056098894041
D237233	0-1	1016065	945457	155470	103478	258948	0.1644389961679907	0.10944760047257569	0.2738865966405664
D237233	1-2	536152	497061	82276	50718	132994	0.16552495568954315	0.102035766233923	0.26756072192346614
D237233	2-3	421585	391595	63111	38455	101566	0.16116395766033784	0.09820094740739795	0.2593649050677358
D237233	3-4	536380	510537	76619	50807	127426	0.15007531285685466	0.0995167833085555	0.24959209616541014
D237233	4-5	404284	389184	51981	33656	85637	0.13356407252096694	0.08647837526722578	0.22004244778819274
D237235	0-1	1016065	996351	168160	108091	276251	0.16877586312454146	0.10848686858346104	0.2772627317080025
D237235	1-2	536152	526658	87671	53764	141435	0.16646666337547328	0.10208522418723347	0.2685518875627067
D237235	2-3	421585	414429	67454	40639	108093	0.16276370620781846	0.09806022261955606	0.26082392882737454
D237235	3-4	536380	529073	82396	51366	133762	0.15573654297233086	0.09708679142575788	0.25282333439808874
D237235	4-5	404284	399926	55189	33294	88483	0.13799802963548258	0.08325040132424498	0.22124843095972754
D237258	0-1	1016065	949605	153284	105323	258607	0.16141869514166415	0.11091243201120465	0.27233112715286883
D237258	1-2	536152	502420	79961	52487	132448	0.15915170574419807	0.10446837307432029	0.26362007881851834
D237258	2-3	421585	395931	61673	40101	101774	0.1557670402166034	0.10128279927563136	0.25704983949223476
D237258	3-4	536380	511869	77511	50409	127920	0.15142741599901538	0.09848027522666933	0.2499076912256847
D237258	4-5	404284	388906	53289	32566	85855	0.13702282813841904	0.08373745840897286	0.2207602865473919
D237276	0-1	1016065	894379	145239	98346	243585	0.1623908879792571	0.1099600952169047	0.2723509831961618
D237276	1-2	536152	479505	76648	49667	126315	0.15984817676562288	0.10357973326659785	0.2634279100322207
D237276	2-3	421585	377726	59035	37667	96702	0.1562905386444142	0.09972043227101127	0.25601097091542546
D237276	3-4	536380	483759	73096	47216	120312	0.15110003121388957	0.09760231850983651	0.24870234972372607
D237276	4-5	404284	366815	49992	30451	80443	0.13628668402328148	0.08301459863964124	0.21930128266292273
D237277	0-1	1016065	949639	160548	102610	263158	0.1690621383494149	0.10805158591843848	0.27711372426785336
D237277	1-2	536152	507954	84937	51415	136352	0.16721396031924152	0.1012197954932927	0.2684337558125342
D237277	2-3	421585	400022	65438	39051	104489	0.16358600276984767	0.09762213078280695	0.2612081335526546
D237277	3-4	536380	512472	80187	49619	129806	0.15647098768322953	0.09682285080941007	0.2532938384926396
D237277	4-5	404284	387520	54090	32005	86095	0.1395798926507019	0.08258928571428571	0.22216917836498762
D237278	0-1	1016065	995788	158478	112386	270864	0.1591483327776595	0.11286137209928218	0.2720097048769417
D237278	1-2	536152	526646	81767	56559	138326	0.15525988994504847	0.10739472055232548	0.26265461049737393
D237278	2-3	421585	414236	62688	42911	105599	0.1513340221516237	0.10359070674687859	0.2549247288985023
D237278	3-4	536380	528907	79018	52901	131919	0.1493986655498982	0.10001947412304998	0.24941813967294818
D237278	4-5	404284	399482	54778	33597	88375	0.13712257373298423	0.08410141132766934	0.22122398506065355
D237300	0-1	1016065	983204	163216	107835	271051	0.166004206654977	0.10967713719634989	0.27568134385132687
D237300	1-2	536152	519123	85515	53226	138741	0.16472974612953	0.10253061413191093	0.26726036026144095
D237300	2-3	421585	408582	66239	40092	106331	0.1621192318800143	0.0981247338355581	0.2602439657155724
D237300	3-4	536380	523998	80795	51050	131845	0.1541895198073275	0.09742403596960293	0.25161355577693045
D237300	4-5	404284	396778	54879	33103	87982	0.13831159993749653	0.0834295248224448	0.22174112475994132
D237304	0-1	1016065	904842	148205	98266	246471	0.16379102649965407	0.10860017550025308	0.2723912019999072
D237304	1-2	536152	472346	77405	47874	125279	0.16387351644768877	0.10135366870895487	0.2652271851566437
D237304	2-3	421585	372216	59912	36619	96531	0.1609603026199841	0.09838104756378017	0.25934135018376425
D237304	3-4	536380	493500	75539	48185	123724	0.1530678824721378	0.09763931104356637	0.25070719351570414
D237304	4-5	404284	378765	51993	31899	83892	0.13726981109659023	0.08421844679418637	0.2214882578907766
D237307	0-1	1016065	933086	150863	102758	253621	0.1616817742416026	0.11012704080867144	0.27180881505027404
D237307	1-2	536152	500874	79918	52551	132469	0.15955709419933956	0.10491860228320896	0.2644756964825485
D237307	2-3	421585	394821	61871	39610	101481	0.15670645685006623	0.1003239442684153	0.2570304011184815
D237307	3-4	536380	507788	76562	50514	127076	0.15077552049280407	0.0994785225330256	0.25025404302582965
D237307	4-5	404284	384902	52519	32427	84946	0.1364477191596822	0.08424741882349274	0.22069513798317494
D237310	0-1	1016065	894788	148736	96385	245121	0.16622484879099853	0.10771825281519198	0.2739431016061905
D237310	1-2	536152	466518	76756	47269	124025	0.1645295572732456	0.10132299289630839	0.265852550169554
D237310	2-3	421585	367578	59087	35857	94944	0.1607468346854273	0.09754936367247223	0.2582961983578995
D237310	3-4	536380	489753	75013	47521	122534	0.15316496274652733	0.09703054396808188	0.2501955067146092
D237310	4-5	404284	376032	51384	31479	82863	0.13664794485575696	0.08371362011743681	0.22036156497319376
D237311	0-1	1016065	941326	153347	103625	256972	0.16290530591952204	0.11008407289291913	0.2729893788124412
D237311	1-2	536152	498941	79979	51954	131933	0.16029751012644783	0.10412854425673576	0.26442605438318356
D237311	2-3	421585	392972	61408	39378	100786	0.1562655863522083	0.10020561261362132	0.25647119896582965
D237311	3-4	536380	503513	76511	49152	125663	0.15195436860617303	0.09761813498360519	0.24957250358977823
D237311	4-5	404284	381566	52000	32152	84152	0.13628048620684233	0.08426327293312297	0.2205437591399653
D237313	0-1	1016065	999140	168110	108789	276899	0.1682546990411754	0.10888263906959986	0.2771373381107753
D237313	1-2	536152	528909	88210	54317	142527	0.16677727170458434	0.10269630503545979	0.26947357674004413
D237313	2-3	421585	416215	67819	40805	108624	0.1629422293766443	0.09803827348846149	0.26098050286510577
D237313	3-4	536380	530210	82355	51788	134143	0.15532524848644877	0.09767450632768149	0.25299975481413023
D237313	4-5	404284	400380	55920	33203	89123	0.13966731604975274	0.08292871771816775	0.22259603376792048
D237325	0-1	1016065	992474	163698	109338	273036	0.16493933342334408	0.11016711772802108	0.27510645115136517
D237325	1-2	536152	524468	84692	54696	139388	0.16148173005788724	0.10428853619286592	0.2657702662507531
D237325	2-3	421585	412591	64871	41329	106200	0.15722834477727338	0.10016941717099985	0.25739776194827324
D237325	3-4	536380	527986	81042	51617	132659	0.15349270624599895	0.09776206187285269	0.2512547681188516
D237325	4-5	404284	399204	54849	33509	88358	0.13739591787657437	0.08393953968397111	0.22133545756054548
D237327	0-1	1016065	961031	157438	105882	263320	0.16382197868747211	0.1101754261829223	0.2739974048703944
D237327	1-2	536152	504955	82115	52156	134271	0.1626184511491123	0.10328841183867869	0.265906862987791
D237327	2-3	421585	397734	63323	39410	102733	0.15920942137207278	0.09908632402560505	0.25829574539767786
D237327	3-4	536380	515260	79223	50488	129711	0.15375344486278772	0.0979854830570974	0.2517389279198851
D237327	4-5	404284	391373	53347	32846	86193	0.1363073078623206	0.08392505359337511	0.22023236145569572
D237337	0-1	1016065	993045	161823	110663	272486	0.1629563614941921	0.11143805164922033	0.27439441314341245
D237337	1-2	536152	524729	83304	55536	138840	0.15875623417040033	0.10583748944693357	0.2645937236173339
D237337	2-3	421585	412974	64418	41817	106235	0.1559856068420772	0.10125819058826947	0.2572437974303467
D237337	3-4	536380	528222	80311	52153	132464	0.15204024065639068	0.09873310842789584	0.25077334908428656
D237337	4-5	404284	399506	54402	33882	88284	0.1361731738697291	0.08480974002893574	0.22098291389866484
D237339	0-1	1016065	974791	162768	106272	269040	0.16697733155107095	0.10902029255501948	0.2759976241060904
D237339	1-2	536152	511829	84896	52200	137096	0.16586789728600762	0.1019871871269506	0.26785508441295824
D237339	2-3	421585	402965	65521	39333	104854	0.16259724789994168	0.09760897348404948	0.2602062213839912
D237339	3-4	536380	522063	81526	50725	132251	0.15616122958340278	0.09716260298086629	0.25332383256426905
D237339	4-5	404284	396854	55343	33027	88370	0.13945430813346973	0.08322204135525911	0.22267634948872886
D237340	0-1	1016065	984188	160718	108877	269595	0.1633001012001772	0.11062622181940848	0.2739263230195857
D237340	1-2	536152	518644	83431	54072	137503	0.16086371383839396	0.10425648421653388	0.26512019805492787
D237340	2-3	421585	408373	64500	40721	105221	0.15794384055752952	0.09971521133865363	0.25765905189618316
D237340	3-4	536380	525199	79944	51559	131503	0.15221658837888113	0.09817040778828597	0.2503869961671671
D237340	4-5	404284	397620	55082	33398	88480	0.13852924903173885	0.08399476887480509	0.22252401790654394
D237352	0-1	1016065	919522	153563	99363	252926	0.1670030733359289	0.10805940477769972	0.2750624781136286
D237352	1-2	536152	486255	80803	49088	129891	0.16617412674419801	0.10095114703190712	0.2671252737761051
D237352	2-3	421585	382962	62243	37372	99615	0.16253048605344655	0.09758670573059468	0.26011719178404125
D237352	3-4	536380	499656	76706	48994	125700	0.1535176201226444	0.09805546215796468	0.25157308228060904
D237352	4-5	404284	381224	52215	31900	84115	0.13696671773025831	0.08367783770171867	0.220644555431977
D237355	0-1	1016065	954740	155227	105133	260360	0.16258562540586965	0.11011689046232483	0.2727025158681945
D237355	1-2	536152	503000	79880	52701	132581	0.15880715705765408	0.10477335984095427	0.26358051689860834
D237355	2-3	421585	396275	62239	39627	101866	0.1570601223897546	0.09999873824995269	0.2570588606397073
D237355	3-4	536380	514269	78713	50423	129136	0.15305802994152864	0.09804790877925755	0.2511059387207862
D237355	4-5	404284	390992	53704	32736	86440	0.1373531939272415	0.08372549821991243	0.2210786921471539
D237360	0-1	1016065	998968	163996	110627	274623	0.1641654187121109	0.11074128500612632	0.2749067037182372
D237360	1-2	536152	529787	85460	55306	140766	0.16131011142213758	0.10439289752296678	0.26570300894510435
D237360	2-3	421585	416586	65715	41933	107648	0.15774653973009176	0.10065868752190424	0.258405227251996
D237360	3-4	536380	530196	80902	52155	133057	0.1525888539332624	0.09836928230314827	0.25095813623641067
D237360	4-5	404284	400282	55027	33687	88714	0.13747058323881664	0.0841581684912137	0.22162875173003033
D237361	0-1	1016065	930160	152921	102023	254944	0.16440289842607722	0.10968328029586308	0.2740861787219403
D237361	1-2	536152	490923	80758	50106	130864	0.16450237613637983	0.10206488593934283	0.2665672620757227
D237361	2-3	421585	386739	61952	38414	100366	0.16019072294234613	0.09932797054344145	0.2595186934857876
D237361	3-4	536380	505849	77617	50035	127652	0.153439069761925	0.09891291670043827	0.2523519864623633
D237361	4-5	404284	386089	52806	32727	85533	0.13677157339369939	0.08476542973252281	0.22153700312622218
D237369	0-1	1016065	949565	157035	103289	260324	0.16537572467392964	0.10877507069026343	0.27415079536419307
D237369	1-2	536152	499042	82070	50976	133046	0.16445509596386676	0.10214771502198212	0.26660281098584887
D237369	2-3	421585	393072	63646	38787	102433	0.16191944478365286	0.09867657833679326	0.2605960231204461
D237369	3-4	536380	511013	78917	49454	128371	0.1544324704068194	0.09677640294865297	0.2512088733554724
D237369	4-5	404284	389408	54369	32112	86481	0.1396196277426247	0.0824636371106911	0.2220832648533158
D237370	0-1	1016065	937141	151229	103388	254617	0.16137272833010188	0.11032277960306934	0.2716955079331712
D237370	1-2	536152	499361	80110	52014	132124	0.16042502317962357	0.1041611179086873	0.26458614108831086
D237370	2-3	421585	393243	61504	39390	100894	0.15640202114214366	0.10016707226829212	0.25656909341043577
D237370	3-4	536380	505917	76914	49838	126752	0.15202889011438636	0.09851022993890302	0.2505391200532894
D237370	4-5	404284	383420	52247	32136	84383	0.13626571383861041	0.08381409420478848	0.22007980804339888
D237371	0-1	1016065	960264	160974	103486	264460	0.16763515033365825	0.10776828038955953	0.27540343072321777
D237371	1-2	536152	507446	84613	51304	135917	0.16674286525068677	0.10110238330778053	0.2678452485584673
D237371	2-3	421585	399583	65382	38922	104304	0.16362557966680263	0.09740654632454333	0.26103212599134595
D237371	3-4	536380	514978	79962	49807	129769	0.15527265242398705	0.09671675294866965	0.2519894053726567
D237371	4-5	404284	390526	53875	32688	86563	0.13795496330590024	0.08370249355996784	0.22165745686586807
D237378	0-1	1016065	968361	162908	104357	267265	0.1682306495201686	0.10776662835450829	0.2759972778746769
D237378	1-2	536152	512253	85138	52095	137233	0.16620302858157981	0.10169779386357913	0.26790082244515895
D237378	2-3	421585	402969	65722	39629	105351	0.16309443158158568	0.09834255240477556	0.2614369839863612
D237378	3-4	536380	516649	80002	49777	129779	0.1548478754434829	0.09634587505250179	0.2511937504959847
D237378	4-5	404284	391248	54644	32323	86967	0.13966588966588966	0.08261511879932933	0.222281008465219
D237379	0-1	1016065	811429	132487	87549	220036	0.16327614615696506	0.1078948373794873	0.27117098353645236
D237379	1-2	536152	427124	69194	43372	112566	0.1619997939708375	0.10154428222249276	0.26354407619333026
D237379	2-3	421585	337649	53615	33367	86982	0.1587891567870777	0.0988215572976671	0.2576107140847448
D237379	3-4	536380	456898	69227	44671	113898	0.1515152178385548	0.09777018065301227	0.24928539849156706
D237379	4-5	404284	352299	47894	29572	77466	0.13594702227369365	0.08394006227664569	0.21988708455033934
D237385	0-1	1016065	979083	162109	107457	269566	0.16557227528207516	0.1097526971666345	0.2753249724487097
D237385	1-2	536152	517194	84559	53278	137837	0.16349570954032722	0.10301356937628821	0.2665092789166154
D237385	2-3	421585	406950	64589	40613	105202	0.15871482983167465	0.09979850104435434	0.258513330876029
D237385	3-4	536380	521224	80115	50769	130884	0.15370550857213022	0.09740341964299418	0.25110892821512437
D237385	4-5	404284	393999	54517	33049	87566	0.13836837149332867	0.08388092355564354	0.2222492950489722
D237389	0-1	1016065	917711	146813	101563	248376	0.1599773784993315	0.11066991678208063	0.2706472952814121
D237389	1-2	536152	484980	76323	50961	127284	0.1573734999381418	0.10507855994061611	0.26245205987875786
D237389	2-3	421585	381544	58562	38513	97075	0.1534868848678003	0.10093986538905081	0.25442675025685113
D237389	3-4	536380	493706	74271	48650	122921	0.15043568439516636	0.09854042689373838	0.24897611128890473
D237389	4-5	404284	372559	50192	31330	81522	0.1347222855977174	0.08409406295378719	0.21881634855150459
D237391	0-1	1016065	991590	168267	107233	275500	0.16969412761322725	0.10814247824201535	0.2778366058552426
D237391	1-2	536152	526715	88981	53205	142186	0.16893576222435283	0.1010128817292084	0.2699486439535612
D237391	2-3	421585	414045	68075	40392	108467	0.1644144960088879	0.09755461362895337	0.2619691096378413
D237391	3-4	536380	524624	81890	50823	132713	0.15609274451797858	0.09687509530635274	0.25296783982433135
D237391	4-5	404284	395658	54931	32804	87735	0.1388345490297176	0.08290998791885922	0.2217445369485768
D237394	0-1	1016065	944127	159147	101791	260938	0.16856524598915187	0.10781494438777833	0.27638019037693023
D237394	1-2	536152	503417	84298	50942	135240	0.16745163552283693	0.10119245079129231	0.2686440863141292
D237394	2-3	421585	396412	64753	38816	103569	0.16334772913029877	0.09791832739674884	0.2612660565270476
D237394	3-4	536380	509643	79428	49359	128787	0.15585027166075077	0.09685014804480784	0.2527004197055586
D237394	4-5	404284	385664	53652	31905	85557	0.13911591437105875	0.08272745187520743	0.2218433662462662
D243901	0-1	1016065	999849	167958	108857	276815	0.1679833654881887	0.1088734398894233	0.27685680537761204
D243901	1-2	536152	529109	89004	53802	142806	0.16821486687998125	0.10168415203672589	0.26989901891670715
D243901	2-3	421585	416097	68383	40784	109167	0.16434389096773108	0.09801560693780537	0.2623594979055365
D243901	3-4	536380	530134	82550	51246	133796	0.15571534744045845	0.09666612592287988	0.2523814733633383
D243901	4-5	404284	400223	55330	33394	88724	0.13824792678081968	0.08343848304570202	0.2216864098265217
D243906	0-1	1016065	935920	151143	104157	255300	0.16149136678348577	0.11128835797931447	0.2727797247628002
D243906	1-2	536152	503530	79848	53108	132956	0.15857645026115624	0.10547137211288304	0.2640478223740393
D243906	2-3	421585	395642	61623	40042	101665	0.1557544446747312	0.10120765742767451	0.2569621021024057
D243906	3-4	536380	500007	75562	49190	124752	0.1511218842936199	0.09837862269928221	0.2495005069929021
D243906	4-5	404284	376745	51309	31486	82795	0.13619026131733666	0.08357377005666963	0.2197640313740063
D243907	0-1	1016065	991250	163464	109807	273271	0.16490693568726356	0.11077629255989911	0.2756832282471627
D243907	1-2	536152	528077	86103	55046	141149	0.16305008549889505	0.10423858641826855	0.2672886719171636
D243907	2-3	421585	414885	66093	41584	107677	0.15930438555262302	0.10023018426792966	0.2595345698205527
D243907	3-4	536380	524957	80534	51360	131894	0.1534106603017009	0.09783658471074774	0.25124724501244866
D243907	4-5	404284	395606	54504	33227	87731	0.13777344125215493	0.08399013159557742	0.22176357284773235
D243916	0-1	1016065	1000905	165910	110760	276670	0.16575998721157353	0.11065985283318597	0.2764198400447595
D243916	1-2	536152	530106	88428	54295	142723	0.16681192063474098	0.10242291164408628	0.2692348322788273
D243916	2-3	421585	416845	67993	41116	109109	0.16311338747016277	0.09863618371337068	0.2617495711835334
D243916	3-4	536380	530206	80532	52658	133190	0.1518881340460123	0.09931611486856053	0.2512042489145728
D243916	4-5	404284	400097	53852	34088	87940	0.13459736014016602	0.08519933916025364	0.21979669930041965
D243918	0-1	1016065	999160	163034	111008	274042	0.16317106369350254	0.111101325113095	0.27427238880659754
D243918	1-2	536152	530452	84736	55802	140538	0.15974301162027854	0.105197077209625	0.26494008882990355
D243918	2-3	421585	416980	64982	42241	107223	0.15583960861432203	0.10130222073001104	0.25714182934433305
D243918	3-4	536380	529825	80684	52504	133188	0.1522842447978106	0.09909687160854999	0.25138111640636057
D243918	4-5	404284	399814	54311	33903	88214	0.135840665909648	0.08479693057271631	0.2206375964823643
D243930	0-1	1016065	994828	163233	110496	273729	0.16408163019134966	0.1110704564005034	0.2751520865918531
D243930	1-2	536152	525755	85582	54968	140550	0.16277924128158552	0.10455059866287529	0.2673298399444608
D243930	2-3	421585	413771	65297	41805	107102	0.15780951299148563	0.1010341469073473	0.25884365989883296
D243930	3-4	536380	528749	79753	52571	132324	0.15083338219079373	0.09942524713994731	0.25025862933074106
D243930	4-5	404284	399776	53855	34329	88184	0.13471293924597774	0.08587058752901625	0.220583526774994
D243937	0-1	1016065	984445	158529	110344	268873	0.16103388203505528	0.11208752139530395	0.27312140343035923
D243937	1-2	536152	519313	82150	55225	137375	0.1581897622435795	0.10634241777117076	0.26453218001475026
D243937	2-3	421585	409146	63353	41515	104868	0.1548420368279294	0.10146744682827157	0.256309483656201
D243937	3-4	536380	524557	78805	52031	130836	0.15023152869945497	0.099190364440852	0.24942189314030697
D243937	4-5	404284	397007	53545	33719	87264	0.13487167732558872	0.08493301125672847	0.2198046885823172
D243940	0-1	1016065	990719	167263	107719	274982	0.1688299103984076	0.10872810554758716	0.2775580159459948
D243940	1-2	536152	523676	87516	53405	140921	0.16711860005041285	0.10198099588295052	0.26909959593336336
D243940	2-3	421585	412110	67733	40441	108174	0.16435660381936862	0.0981315668146854	0.262488170634054
D243940	3-4	536380	527304	83415	50668	134083	0.15819147967775704	0.0960887836997254	0.25428026337748244
D243940	4-5	404284	398608	56001	33112	89113	0.14049141010717295	0.08306908039979127	0.22356049050696425
D243950	0-1	1016065	998950	164341	110391	274732	0.16451373942639771	0.11050703238400321	0.2750207718104009
D243950	1-2	536152	528761	85709	55352	141061	0.1620940273582961	0.10468245577869775	0.2667764831369938
D243950	2-3	421585	415954	66182	41787	107969	0.15910893993085773	0.10046062785788813	0.25956956778874585
D243950	3-4	536380	530203	81439	52062	133501	0.15359965899853453	0.09819257906877177	0.2517922380673063
D243950	4-5	404284	400355	55455	33319	88774	0.13851456832061546	0.08322363902036942	0.22173820734098487
D244001	0-1	1016065	1000178	167470	109601	277071	0.16744019564517515	0.10958149449398007	0.27702169013915523
D244001	1-2	536152	529887	88480	54344	142824	0.16697899740888153	0.10255771513549115	0.26953671254437267
D244001	2-3	421585	416870	68099	40976	109075	0.1633578813538993	0.09829443231702929	0.26165231367092856
D244001	3-4	536380	530739	82938	51128	134066	0.15626890053303036	0.09633360276896931	0.2526025033019997
D244001	4-5	404284	400873	56190	33524	89714	0.1401690809807595	0.08362748301831253	0.22379656399907202
D244005	0-1	1016065	977023	163775	106022	269797	0.16762655536256568	0.10851535736620326	0.2761419127287689
D244005	1-2	536152	516158	86741	52253	138994	0.16805125562327813	0.10123450571336684	0.269285761336645
D244005	2-3	421585	406434	66720	39605	106325	0.16415949453047726	0.09744509563668394	0.2616045901671612
D244005	3-4	536380	520814	80954	50536	131490	0.15543744983813798	0.09703272185463524	0.25247017169277325
D244005	4-5	404284	393782	54069	33080	87149	0.13730693632517485	0.08400587126887465	0.2213128075940495
D244017	0-1	1016065	979772	159230	108840	268070	0.16251740200781406	0.11108706923651625	0.2736044712443303
D244017	1-2	536152	519837	82990	54961	137951	0.15964619678860872	0.10572737223398873	0.26537356902259746
D244017	2-3	421585	408872	64149	41225	105374	0.15689262165176387	0.10082617542898512	0.25771879708074896
D244017	3-4	536380	521535	79132	51495	130627	0.15172903064990845	0.09873738100031637	0.2504664116502248
D244017	4-5	404284	394070	53707	33177	86884	0.13628796914253813	0.08419062603090821	0.22047859517344634
D244025	0-1	1016065	1001272	166456	110183	276639	0.16624453694900088	0.1100430252718542	0.2762875622208551
D244025	1-2	536152	531301	88065	54728	142793	0.16575349942876072	0.1030075230424938	0.26876102247125455
D244025	2-3	421585	417674	68036	41229	109265	0.16289259087230712	0.09871095639182711	0.2616035472641342
D244025	3-4	536380	529922	82406	51798	134204	0.15550590464257003	0.0977464607998913	0.2532523654424613
D244025	4-5	404284	399698	55490	33283	88773	0.13882981651146617	0.08327036912869216	0.22210018564015832
D244027	0-1	1016065	996655	168661	108116	276777	0.1692270645308557	0.10847886179269657	0.2777059263235523
D244027	1-2	536152	527248	88252	53755	142007	0.1673823324128304	0.10195391921828058	0.26933625163111097
D244027	2-3	421585	414843	68113	40800	108913	0.1641898260305706	0.09835046029461748	0.2625402863251881
D244027	3-4	536380	529065	83128	50926	134054	0.15712247077391248	0.09625660363093382	0.2533790744048463
D244027	4-5	404284	399735	55957	33053	89010	0.13998524022164685	0.08268728032321412	0.22267252054486097
D244029	0-1	1016065	1001560	166494	110163	276657	0.16623467390870242	0.10999141339510364	0.27622608730380604
D244029	1-2	536152	531154	87391	55019	142410	0.16453043750023533	0.10358389468967569	0.26811433218991104
D244029	2-3	421585	417646	67365	41706	109071	0.1612968877949268	0.09985968978512903	0.26115657758005584
D244029	3-4	536380	530712	82128	51713	133841	0.15475059919504364	0.09744079651487059	0.2521913957099142
D244029	4-5	404284	400227	55313	33427	88740	0.13820406919073425	0.08352010234192096	0.22172417153265522
D244032	0-1	1016065	961098	160683	104453	265136	0.16718690497743205	0.10868090454875569	0.2758678095261878
D244032	1-2	536152	505983	84377	51197	135574	0.16675856698742844	0.10118324133419503	0.26794180832162345
D244032	2-3	421585	398565	64918	39196	104114	0.1628793295949218	0.098342804812264	0.2612221344071858
D244032	3-4	536380	517623	80072	50420	130492	0.15469173510450657	0.09740679992967854	0.2520985350341851
D244032	4-5	404284	393621	53441	33433	86874	0.135767654672896	0.08493703333917652	0.22070468801207252
D244033	0-1	1016065	995200	163368	110000	273368	0.16415594855305465	0.11053054662379422	0.2746864951768489
D244033	1-2	536152	526235	85136	54708	139844	0.161783233726377	0.1039611580377588	0.2657443917641358
D244033	2-3	421585	414386	65577	41579	107156	0.15825100268831477	0.10033881453524009	0.25858981722355484
D244033	3-4	536380	528744	80894	51710	132604	0.15299275263643652	0.0977978000695989	0.25079055270603545
D244033	4-5	404284	399530	54790	33493	88283	0.13713613495857632	0.08383100142667635	0.22096713638525267
D244042	0-1	1016065	1001490	166208	109755	275963	0.1659607185293912	0.10959170835455172	0.27555242688394294
D244042	1-2	536152	530398	86686	54867	141553	0.16343575956168763	0.10344496019969909	0.2668807197613867
D244042	2-3	421585	417070	67003	41372	108375	0.1606516891648884	0.09919677751936126	0.25984846668424966
D244042	3-4	536380	530891	80710	52319	133029	0.15202744066107732	0.09854941974906337	0.2505768604101407
D244042	4-5	404284	400411	54858	33689	88547	0.13700422815557015	0.08413605020841086	0.221140278363981
D244045	0-1	1016065	998851	162393	111257	273650	0.16257980419502008	0.11138498134356375	0.27396478553858383
D244045	1-2	536152	529465	85208	55749	140957	0.16093226181145118	0.10529307886262548	0.26622534067407666
D244045	2-3	421585	416413	65642	42295	107937	0.15763676926512862	0.1015698357159839	0.2592066049811125
D244045	3-4	536380	529970	80251	52422	132673	0.1514255523897579	0.09891503292639206	0.25034058531614994
D244045	4-5	404284	400072	54247	33853	88100	0.13559309324321622	0.08461726889159951	0.22021036213481573
D244054	0-1	1016065	1001364	169474	109017	278491	0.16924315234020795	0.10886850336141503	0.278111655701623
D244054	1-2	536152	529992	88803	53960	142763	0.16755535932617852	0.10181285755256683	0.26936821687874535
D244054	2-3	421585	416701	68983	40695	109678	0.16554555904593463	0.09765995281988764	0.26320551186582225
D244054	3-4	536380	530439	83735	51228	134963	0.15785981045888406	0.09657660918597614	0.2544364196448602
D244054	4-5	404284	400386	55907	33075	88982	0.1396327543920117	0.08260778348893318	0.2222405378809449
D244055	0-1	1016065	999917	165720	109870	275590	0.16573375590173983	0.10987911996695726	0.2756128758686971
D244055	1-2	536152	528833	85734	55053	140787	0.16211923234745185	0.10410280750255752	0.26622203985000936
D244055	2-3	421585	415948	66165	41401	107566	0.15907036456480136	0.09953407637493149	0.25860444093973284
D244055	3-4	536380	529576	81367	52081	133448	0.1536455579557986	0.09834471350665439	0.251990271462453
D244055	4-5	404284	399937	55276	33417	88693	0.13821176835351567	0.0835556600164526	0.22176742836996827
D244073	0-1	1016065	999773	168020	109034	277054	0.16805814919986836	0.10905875633768866	0.277116905537557
D244073	1-2	536152	530200	88850	54058	142908	0.1675782723500566	0.10195775179177669	0.26953602414183325
D244073	2-3	421585	417042	68124	40971	109095	0.16335045391111686	0.098241903693153207	0.2615923576042701
D244073	3-4	536380	530234	82270	51686	133956	0.15515791141269702	0.09747771738515448	0.2526356287978515
D244073	4-5	404284	400348	55144	33661	88805	0.1377401660555317	0.08407935096466075	0.22181951702019242
D244077	0-1	1016065	1001484	168470	109611	278081	0.1682203609842993	0.10944857830978827	0.2776689392940876
D244077	1-2	536152	529390	87496	54581	142077	0.1652770169440299	0.10310168306919285	0.2683787000132228
D244077	2-3	421585	416627	68029	40861	108890	0.1632851447457798	0.09807573681014432	0.26136088155592413
D244077	3-4	536380	530685	82813	51537	134350	0.1560492570922487	0.09711410723875745	0.25316336433100617
D244077	4-5	404284	400634	55871	33280	89151	0.13945646150850902	0.08306833668635213	0.22252479819486115
D244083	0-1	1016065	995312	168054	108287	276341	0.1688455479286897	0.10879704052598582	0.27764258845467554
D244083	1-2	536152	525969	88090	53625	141715	0.1674813534637973	0.10195467793729288	0.2694360314010902
D244083	2-3	421585	413928	68316	40418	108734	0.1650431959181307	0.0976450010629868	0.2626881969811175
D244083	3-4	536380	528402	82240	51357	133597	0.1556390778233239	0.09719304620345873	0.2528321240267826
D244083	4-5	404284	399260	55236	33225	88461	0.13834593998897962	0.08321645043330161	0.2215623904222812
D244086	0-1	1016065	997456	169044	108349	277393	0.16947514476829054	0.10862534287226705	0.27810048764055756
D244086	1-2	536152	527572	88220	53674	141894	0.167218881972508	0.1017377722851099	0.26895665425761794
D244086	2-3	421585	415115	68276	40373	108649	0.16447490454452382	0.09725738650735338	0.2617322910518772
D244086	3-4	536380	529841	83284	50884	134168	0.15718677867511197	0.09603635807723448	0.2532231367523465
D244086	4-5	404284	400227	56093	33124	89217	0.14015296319338774	0.08276303197935171	0.22291599517273947
D244087	0-1	1016065	1001314	167657	109577	277234	0.16743698779803337	0.10943320476893362	0.276870192566967
D244087	1-2	536152	530232	89565	53554	143119	0.1689166251753949	0.10100107122919778	0.26991769640459273
D244087	2-3	421585	416944	68093	40966	109059	0.1633144978702176	0.09825300280133543	0.261567500671553
D244087	3-4	536380	531213	81271	52539	133810	0.15299136128069155	0.09890382953730424	0.2518951908179958
D244087	4-5	404284	401167	53909	34212	88121	0.13438044505156208	0.08528119212198411	0.21966163717354617
D244090	0-1	1016065	1000561	165802	110458	276260	0.1657090372301139	0.11039606780596085	0.27610510503607477
D244090	1-2	536152	530274	86217	55570	141787	0.16258952918679778	0.10479487962826765	0.2673844088150654
D244090	2-3	421585	416833	66156	42041	108197	0.15871104255181331	0.10085813743153733	0.25956917998335066
D244090	3-4	536380	530102	81736	51864	133600	0.15418919377780124	0.09783777461696051	0.25202696839476174
D244090	4-5	404284	399978	55612	33207	88819	0.13903764707058888	0.08302206621364175	0.22205971328423063
D244112	0-1	1016065	999830	149481	117982	267463	0.14950641609073542	0.11800206035025955	0.26750847644099496
D244112	1-2	536152	529901	79178	58820	137998	0.14942036342637588	0.11100186638636274	0.2604222298127386
D244112	2-3	421585	416722	60635	44756	105391	0.1455046769788972	0.10740013726177164	0.25290481424066885
D244112	3-4	536380	530278	69399	58026	127425	0.13087286291341524	0.10942562203221706	0.2402984849456323
D244112	4-5	404284	400061	45995	38083	84078	0.1149699670800203	0.09519298307008181	0.2101629501501021
D244123	0-1	1016065	991281	166025	107883	273908	0.1674853043687915	0.10883190538303468	0.27631720975182616
D244123	1-2	536152	523963	88149	53176	141325	0.16823516164309313	0.10148808217374128	0.2697232438168344
D244123	2-3	421585	412279	67285	40447	107732	0.16320258853834418	0.09810589430943609	0.26130848284778024
D244123	3-4	536380	527418	81498	51561	133059	0.1545225987736482	0.09776116856079997	0.2522837673344482
D244123	4-5	404284	399074	54789	33591	88380	0.13729032710725328	0.08417235901111073	0.221462686118364
D244139	0-1	1016065	986213	160473	110030	270503	0.16271637060148264	0.11156819064441455	0.2742845612458972
D244139	1-2	536152	520700	84958	54025	138983	0.16316112924908777	0.10375456116765892	0.2669156904167467
D244139	2-3	421585	409749	65372	41093	106465	0.15954157301177063	0.10028822523056798	0.2598297982423386
D244139	3-4	536380	525816	79053	52387	131440	0.15034346615546124	0.09962990856116968	0.24997337471663092
D244139	4-5	404284	398130	53150	34108	87258	0.13349910833144954	0.08567050963253209	0.21916961796398163
D244143	0-1	1016065	999286	167397	109344	276741	0.1675166068572961	0.10942212739896286	0.276938734256259
D244143	1-2	536152	528178	88140	54018	142158	0.16687556089045738	0.10227234000658869	0.26914790089704604
D244143	2-3	421585	415492	68195	40680	108875	0.16413071731826365	0.09790802229645817	0.26203873961472185
D244143	3-4	536380	529695	81623	51566	133189	0.15409433730731836	0.09735036200077403	0.2514446993080924
D244143	4-5	404284	400273	54751	33701	88452	0.13678414482115955	0.0841950368873244	0.22097918170848396
D244144	0-1	1016065	985772	160827	109057	269884	0.16314827363731166	0.11063105870322955	0.27377933234054125
D244144	1-2	536152	520170	83567	54448	138015	0.16065324797662303	0.10467347213411	0.26532672011073305
D244144	2-3	421585	409295	64189	41377	105566	0.15682820459570726	0.10109334343199892	0.25792154802770617
D244144	3-4	536380	525321	80097	51771	131868	0.1524724882500414	0.0985511715693833	0.2510236598194247
D244144	4-5	404284	397730	54007	33524	87531	0.13578809745304604	0.08428833630855102	0.22007643376159705
D244147	0-1	1016065	1001381	162746	112367	275113	0.16252155772877655	0.11221203517941722	0.27473359290819377
D244147	1-2	536152	531261	85229	56349	141578	0.16042773702568042	0.10606650968168188	0.26649424670736227
D244147	2-3	421585	417605	66292	41928	108220	0.15874331006573197	0.10040109673016367	0.2591444067958956
D244147	3-4	536380	529863	81483	51949	133432	0.15378126043901913	0.09804232414794013	0.25182358458695925
D244147	4-5	404284	399733	54646	33675	88321	0.13670625142282475	0.08424373269157162	0.22094998411439637
D244162	0-1	1016065	984549	161159	109630	270789	0.16368814553668737	0.11135047620788809	0.27503862174457544
D244162	1-2	536152	520814	84623	54268	138891	0.1624821913389425	0.10419842784564164	0.26668061918458413
D244162	2-3	421585	409847	65025	41364	106389	0.15865676703745543	0.1009254673085322	0.25958223434598765
D244162	3-4	536380	524206	78873	51963	130836	0.15046184133718424	0.09912706073566499	0.24958890207284923
D244162	4-5	404284	395982	53394	33560	86954	0.13483946239980604	0.08475132708052387	0.21959078948032992
D244163	0-1	1016065	985827	159572	110315	269887	0.16186612864123218	0.11190097248300158	0.27376710112423375
D244163	1-2	536152	520355	82949	54657	137606	0.15940848074871963	0.10503790681361763	0.26444638756233724
D244163	2-3	421585	409460	63552	41643	105195	0.1552093000537293	0.10170224197723832	0.2569115420309676
D244163	3-4	536380	523857	78101	52380	130481	0.14908839626081163	0.09998911916801723	0.24907751542882886
D244163	4-5	404284	396193	52416	33867	86283	0.1322991572289263	0.08548106604609369	0.21778022327502
D244168	0-1	1016065	1000284	164325	110882	275207	0.16427834495003418	0.11085051845275942	0.27512886340279363
D244168	1-2	536152	529619	86159	55003	141162	0.16268109716607598	0.10385390252237929	0.2665349996884553
D244168	2-3	421585	416516	66020	42139	108159	0.1585053155220928	0.10117018313822278	0.2596754986603156
D244168	3-4	536380	530451	80225	52451	132676	0.1512392285055547	0.09888000965216391	0.25011923815771864
D244168	4-5	404284	400247	54298	33963	88261	0.13566122919097456	0.08485510197453072	0.2205163311655053
D244179	0-1	1016065	954039	158077	104485	262562	0.16569238783739448	0.10951858362184355	0.27521097145923806
D244179	1-2	536152	501259	82256	51984	134240	0.16409879922355508	0.10370686611113217	0.26780566533468725
D244179	2-3	421585	394931	63025	39442	102467	0.15958483887058753	0.09987061030914261	0.2594554491797301
D244179	3-4	536380	514702	79282	50465	129747	0.15403476186220377	0.0980470252689906	0.25208178713119433
D244179	4-5	404284	391972	54352	32966	87318	0.13866296572204137	0.08410294612880512	0.2227659118508465
D244183	0-1	1016065	1000949	170878	107991	278869	0.17071599052499178	0.1078886137055934	0.2786046042305852
D244183	1-2	536152	529518	90435	53292	143727	0.17078739532933723	0.10064247107747046	0.2714298664068077
D244183	2-3	421585	416280	69248	40406	109654	0.16634957240319015	0.09706447583357355	0.26341404823676373
D244183	3-4	536380	529139	83135	50990	134125	0.15711372626096357	0.0963640933667713	0.25347781962773486
D244183	4-5	404284	399382	55067	33328	88395	0.13788052541176118	0.08344892859467878	0.22132945400643994
D244186	0-1	1016065	997529	165042	109458	274500	0.16545082899845517	0.10972914070668623	0.2751799697051414
D244186	1-2	536152	527537	85229	55097	140326	0.16156023179416798	0.10444196331252595	0.26600219510669393
D244186	2-3	421585	414923	66192	41567	107759	0.1595283944249897	0.10018003340378817	0.25970842782877784
D244186	3-4	536380	529040	81163	51811	132974	0.15341562074701345	0.09793399364887344	0.2513496143958869
D244186	4-5	404284	399540	54430	33586	88016	0.13623166641637885	0.08406167092155979	0.22029333733793863
D247994	0-1	1016065	977920	165304	105404	270708	0.1690363219895288	0.10778386780104712	0.27682018979057593
D247994	1-2	536152	517255	86413	52435	138848	0.16706073406733624	0.10137166387951783	0.2684323979468541
D247994	2-3	421585	407038	67181	39713	106894	0.16504847213282298	0.09756582923461692	0.2626143013674399
D247994	3-4	536380	521705	81476	50279	131755	0.15617254962095437	0.09637438782453686	0.2525469374454912
D247994	4-5	404284	394958	54728	32875	87603	0.1385666324014199	0.0832366985856724	0.2218033309870923
